date,state,positive,negative,death,totalTestResults
2020-03-06,AK,0,8,0,8
2020-03-07,AK,0,12,0,12
2020-03-08,AK,0,14,0,14
2020-03-09,AK,0,23,0,23
2020-03-10,AK,0,23,0,23
2020-03-11,AK,0,46,0,46
2020-03-12,AK,0,46,0,46
2020-03-13,AK,1,59,0,60
2020-03-14,AK,1,143,0,144
2020-03-15,AK,1,143,0,144
2020-03-16,AK,1,143,0,144
2020-03-17,AK,3,334,0,337
2020-03-18,AK,6,406,0,412
2020-03-19,AK,6,432,0,438
2020-03-20,AK,12,686,0,698
2020-03-21,AK,14,758,0,772
2020-03-22,AK,22,946,0,968
2020-03-23,AK,22,946,0,968
2020-03-24,AK,36,986,0,1022
2020-03-25,AK,42,1649,1,1691
2020-03-26,AK,59,1801,1,1860
2020-03-27,AK,69,2319,1,2388
2020-03-28,AK,85,2836,2,2921
2020-03-29,AK,102,3232,2,3334
2020-03-30,AK,114,3540,3,3654
2020-03-31,AK,119,3594,3,3713
2020-04-01,AK,133,4470,3,4603
2020-04-02,AK,143,4879,3,5022
2020-04-03,AK,157,5859,3,6016
2020-04-04,AK,171,5869,5,6040
2020-04-05,AK,185,6099,6,6284
2020-04-06,AK,191,6692,6,6883
2020-04-07,AK,213,6700,6,6913
2020-04-08,AK,226,6842,7,7068
2020-04-09,AK,235,6988,7,7223
2020-04-10,AK,246,7186,7,7432
2020-04-11,AK,257,7475,8,7732
2020-04-12,AK,272,7766,8,8038
2020-04-13,AK,277,7553,8,7830
2020-04-14,AK,285,8063,9,8348
2020-04-15,AK,293,8371,9,8664
2020-04-16,AK,300,8435,9,8735
2020-04-17,AK,309,9141,9,9450
2020-04-18,AK,314,9341,9,9655
2020-04-19,AK,319,9576,9,9895
2020-04-20,AK,321,9803,9,10124
2020-04-21,AK,329,10790,9,11119
2020-04-22,AK,335,11824,9,12159
2020-04-23,AK,337,11824,9,12161
2020-04-24,AK,339,11942,9,12281
2020-04-25,AK,339,15393,9,15732
2020-04-26,AK,341,15836,9,16177
2020-04-27,AK,345,15911,9,16256
2020-04-28,AK,351,16738,9,17089
2020-04-29,AK,355,18764,9,19119
2020-04-30,AK,355,18764,9,19119
2020-05-01,AK,364,19961,9,20325
2020-05-02,AK,365,21034,9,21399
2020-05-03,AK,368,21210,9,21578
2020-05-04,AK,370,21353,9,21723
2020-05-05,AK,371,22321,9,22692
2020-05-06,AK,372,23283,10,23655
2020-05-07,AK,374,23967,10,24341
2020-05-08,AK,377,25096,10,25473
2020-05-09,AK,378,26071,10,26449
2020-05-10,AK,379,26985,10,27364
2020-05-11,AK,381,28299,10,28680
2020-05-12,AK,383,29578,10,29961
2020-05-13,AK,383,30266,10,30649
2020-05-14,AK,387,31375,10,31762
2020-05-15,AK,388,32030,10,32418
2020-05-16,AK,392,32889,10,33281
2020-05-17,AK,396,34255,10,34651
2020-05-18,AK,399,35212,10,35611
2020-05-19,AK,399,35981,10,36380
2020-05-20,AK,402,36643,10,37045
2020-05-21,AK,402,39143,10,39545
2020-05-22,AK,404,41042,10,41446
2020-05-23,AK,408,41943,10,42351
2020-05-24,AK,408,43099,10,43507
2020-05-25,AK,409,44063,10,44472
2020-05-26,AK,411,44553,10,44964
2020-05-27,AK,412,45951,10,46363
2020-05-28,AK,425,47545,10,47970
2020-05-29,AK,430,49009,10,49439
2020-05-30,AK,434,51261,10,51695
2020-05-31,AK,434,51261,10,51695
2020-06-01,AK,467,53723,10,54190
2020-06-02,AK,487,55716,10,56203
2020-06-03,AK,505,57677,10,58182
2020-06-04,AK,513,59584,10,60097
2020-06-05,AK,524,60466,10,60990
2020-06-06,AK,536,63365,10,63901
2020-06-07,AK,544,64360,10,64904
2020-06-08,AK,563,65349,10,65912
2020-06-09,AK,573,66317,11,66890
2020-06-10,AK,593,67127,11,67720
2020-06-11,AK,611,68400,11,69011
2020-06-12,AK,625,70255,12,70880
2020-06-13,AK,654,71149,12,71803
2020-06-14,AK,661,72806,12,73467
2020-06-15,AK,664,73773,12,74437
2020-06-16,AK,676,75539,12,76215
2020-06-17,AK,696,77013,12,77709
2020-06-18,AK,708,80477,12,81185
2020-06-19,AK,722,82909,12,83631
2020-06-20,AK,743,86175,12,86918
2020-06-21,AK,755,87296,12,88051
2020-06-22,AK,761,90063,12,90824
2020-06-23,AK,778,92169,12,92947
2020-06-24,AK,792,95304,12,96096
2020-06-25,AK,816,98636,12,99452
2020-06-26,AK,836,100956,14,101792
2020-06-27,AK,854,104727,14,105581
2020-06-28,AK,883,107417,14,108300
2020-06-29,AK,904,107805,14,108709
2020-06-30,AK,940,111245,14,112185
2020-07-01,AK,978,113422,14,114400
2020-07-02,AK,1017,114892,14,115909
2020-07-03,AK,1063,119145,15,120208
2020-07-04,AK,1111,121621,16,122732
2020-07-05,AK,1138,122615,16,123753
2020-07-06,AK,1138,122615,16,123753
2020-07-07,AK,1184,130236,17,131420
2020-07-08,AK,1226,132175,17,133401
2020-07-09,AK,1272,134472,17,135744
2020-07-10,AK,1323,140608,17,141931
2020-07-11,AK,1385,141991,17,143376
2020-07-12,AK,1479,143996,17,145475
2020-07-13,AK,1539,145051,17,146590
2020-07-14,AK,1579,147894,17,149473
2020-07-15,AK,1631,154462,17,156093
2020-07-16,AK,2032,160990,17,163022
2020-07-17,AK,2081,163333,17,165414
2020-07-18,AK,2159,166204,18,168363
2020-07-19,AK,2277,170733,18,173010
2020-07-20,AK,2414,173172,18,175586
2020-07-21,AK,2525,176101,18,178626
2020-07-22,AK,2619,182714,19,185333
2020-07-23,AK,2684,186825,19,189509
2020-03-07,AL,0,0,0,0
2020-03-08,AL,0,0,0,0
2020-03-09,AL,0,0,0,0
2020-03-10,AL,0,0,0,0
2020-03-11,AL,0,10,0,10
2020-03-12,AL,0,10,0,10
2020-03-13,AL,1,11,0,12
2020-03-14,AL,6,22,0,28
2020-03-15,AL,12,28,0,40
2020-03-16,AL,28,28,0,56
2020-03-17,AL,36,28,0,64
2020-03-18,AL,46,28,0,74
2020-03-19,AL,68,28,0,96
2020-03-20,AL,81,28,0,109
2020-03-21,AL,124,28,0,152
2020-03-22,AL,138,1464,0,1602
2020-03-23,AL,167,1665,0,1832
2020-03-24,AL,215,2106,0,2321
2020-03-25,AL,283,2529,0,2812
2020-03-26,AL,506,3593,1,4099
2020-03-27,AL,587,4184,3,4771
2020-03-28,AL,696,4184,3,4880
2020-03-29,AL,806,4184,4,4990
2020-03-30,AL,859,5694,6,6553
2020-03-31,AL,981,6298,13,7279
2020-04-01,AL,1077,6697,26,7774
2020-04-02,AL,1233,7503,32,8736
2020-04-03,AL,1432,8187,35,9619
2020-04-04,AL,1580,9273,43,10853
2020-04-05,AL,1796,11282,45,13078
2020-04-06,AL,1968,12797,50,14765
2020-04-07,AL,2119,12797,56,14916
2020-04-08,AL,2369,16753,66,19122
2020-04-09,AL,2769,18058,74,20827
2020-04-10,AL,2968,18058,80,21026
2020-04-11,AL,3191,18058,91,21249
2020-04-12,AL,3525,18058,93,21583
2020-04-13,AL,3734,25448,99,29182
2020-04-14,AL,3876,29241,110,33117
2020-04-15,AL,4113,29964,121,34077
2020-04-16,AL,4345,32046,133,36391
2020-04-17,AL,4530,33318,144,37848
2020-04-18,AL,4655,37883,146,42538
2020-04-19,AL,4837,40875,154,45712
2020-04-20,AL,5025,40875,167,45900
2020-04-21,AL,5231,43295,177,48526
2020-04-22,AL,5465,43295,194,48760
2020-04-23,AL,5778,46863,197,52641
2020-04-24,AL,5832,46863,197,52695
2020-04-25,AL,6137,65207,212,71344
2020-04-26,AL,6270,67281,216,73551
2020-04-27,AL,6499,67498,222,73997
2020-04-28,AL,6687,69140,242,75827
2020-04-29,AL,6842,73607,245,80449
2020-04-30,AL,7019,80177,269,87196
2020-05-01,AL,7158,84775,279,91933
2020-05-02,AL,7434,84775,288,92209
2020-05-03,AL,7725,84775,290,92500
2020-05-04,AL,8025,95092,296,103117
2020-05-05,AL,8285,98481,313,106766
2020-05-06,AL,8581,100935,340,109516
2020-05-07,AL,8898,106275,349,115173
2020-05-08,AL,9221,110893,375,120114
2020-05-09,AL,9567,115927,388,125494
2020-05-10,AL,9777,117644,393,127421
2020-05-11,AL,10009,119435,401,129444
2020-05-12,AL,10310,122908,429,133218
2020-05-13,AL,10617,125755,449,136372
2020-05-14,AL,10968,131017,467,141985
2020-05-15,AL,11216,134847,476,146063
2020-05-16,AL,11523,141971,485,153494
2020-05-17,AL,11771,144579,488,156350
2020-05-18,AL,12086,145037,489,157123
2020-05-19,AL,12376,145190,504,157566
2020-05-20,AL,12744,151706,517,164450
2020-05-21,AL,13119,157620,529,170739
2020-05-22,AL,13563,164205,537,177768
2020-05-23,AL,13938,168738,546,182676
2020-05-24,AL,14327,171472,551,185799
2020-05-25,AL,14730,175585,562,190315
2020-05-26,AL,15396,178363,575,193759
2020-05-27,AL,15843,179951,581,195794
2020-05-28,AL,16310,184171,590,200481
2020-05-29,AL,16823,192060,605,208883
2020-05-30,AL,17359,194842,618,212201
2020-05-31,AL,17903,199650,631,217553
2020-06-01,AL,18363,205160,646,223523
2020-06-02,AL,18642,205160,651,223802
2020-06-03,AL,18851,212743,653,231594
2020-06-04,AL,19072,216227,653,235299
2020-06-05,AL,19387,220086,676,239473
2020-06-06,AL,20043,225601,689,245644
2020-06-07,AL,20500,239066,692,259566
2020-06-08,AL,20925,239066,718,259991
2020-06-09,AL,21422,246317,729,267739
2020-06-10,AL,21989,251068,744,273057
2020-06-11,AL,22845,255981,755,278826
2020-06-12,AL,23710,262675,769,286385
2020-06-13,AL,24601,268651,773,293252
2020-06-14,AL,25615,271840,773,297455
2020-06-15,AL,26272,276402,774,302674
2020-06-16,AL,26912,278512,785,305424
2020-06-17,AL,27312,283411,790,310723
2020-06-18,AL,28206,294328,810,322534
2020-06-19,AL,29002,302323,822,331325
2020-06-20,AL,29549,309974,838,339523
2020-06-21,AL,30021,314657,839,344678
2020-06-22,AL,30454,318656,841,349110
2020-06-23,AL,31097,322941,864,354038
2020-06-24,AL,32064,326695,891,358759
2020-06-25,AL,33206,336252,896,369458
2020-06-26,AL,34183,344140,907,378323
2020-06-27,AL,35083,348943,919,384026
2020-06-28,AL,35441,350839,919,386280
2020-06-29,AL,37175,356118,929,393293
2020-06-30,AL,38045,368607,950,406652
2020-07-01,AL,38962,374991,972,413953
2020-07-02,AL,40111,379617,985,419728
2020-07-03,AL,41865,388766,1006,430631
2020-07-04,AL,42862,399226,1007,442088
2020-07-05,AL,43953,405933,1007,449886
2020-07-06,AL,44878,410217,1007,455095
2020-07-07,AL,45785,415579,1033,461364
2020-07-08,AL,46962,421330,1058,468292
2020-07-09,AL,49174,421330,1068,470504
2020-07-10,AL,50508,441708,1104,492216
2020-07-11,AL,51947,450073,1114,502020
2020-07-12,AL,53587,457919,1121,511506
2020-07-13,AL,55545,464059,1124,519604
2020-07-14,AL,57255,471834,1164,529089
2020-07-15,AL,59067,481982,1211,541049
2020-07-16,AL,61088,490021,1230,551109
2020-07-17,AL,63091,500024,1265,563115
2020-07-18,AL,65234,509261,1286,574495
2020-07-19,AL,67011,518522,1287,585533
2020-07-20,AL,68891,524897,1291,593788
2020-07-21,AL,70358,530023,1303,600381
2020-07-22,AL,71813,537675,1364,609488
2020-07-23,AL,74212,545315,1397,619527
2020-03-06,AR,0,6,0,6
2020-03-07,AR,0,6,0,6
2020-03-08,AR,0,6,0,6
2020-03-09,AR,0,12,0,12
2020-03-10,AR,0,12,0,12
2020-03-11,AR,0,12,0,12
2020-03-12,AR,6,24,0,30
2020-03-13,AR,9,30,0,39
2020-03-14,AR,12,65,0,77
2020-03-15,AR,16,103,0,119
2020-03-16,AR,22,132,0,154
2020-03-17,AR,22,197,0,219
2020-03-18,AR,33,236,0,269
2020-03-19,AR,46,310,0,356
2020-03-20,AR,96,351,0,447
2020-03-21,AR,118,567,0,685
2020-03-22,AR,165,711,0,876
2020-03-23,AR,174,906,0,1080
2020-03-24,AR,218,947,0,1165
2020-03-25,AR,280,1437,2,1717
2020-03-26,AR,335,1504,3,1839
2020-03-27,AR,381,1545,3,1926
2020-03-28,AR,404,2938,5,3342
2020-03-29,AR,426,3027,6,3453
2020-03-30,AR,473,5262,7,5735
2020-03-31,AR,523,5959,8,6482
2020-04-01,AR,584,7354,10,7938
2020-04-02,AR,643,7880,12,8523
2020-04-03,AR,704,8995,12,9699
2020-04-04,AR,743,9627,14,10370
2020-04-05,AR,830,10412,16,11242
2020-04-06,AR,875,11970,16,12845
2020-04-07,AR,946,12692,16,13638
2020-04-08,AR,1000,13530,18,14530
2020-04-09,AR,1119,13832,21,14951
2020-04-10,AR,1171,15949,23,17120
2020-04-11,AR,1226,17352,24,18578
2020-04-12,AR,1280,18442,27,19722
2020-04-13,AR,1410,19394,30,20804
2020-04-14,AR,1480,19651,30,21131
2020-04-15,AR,1569,20265,33,21834
2020-04-16,AR,1620,21055,37,22675
2020-04-17,AR,1695,21799,37,23494
2020-04-18,AR,1739,22402,38,24141
2020-04-19,AR,1781,22428,40,24209
2020-04-20,AR,1923,24630,42,26553
2020-04-21,AR,2227,25214,43,27441
2020-04-22,AR,2276,27437,42,29713
2020-04-23,AR,2465,29125,45,31590
2020-04-24,AR,2741,32837,45,35578
2020-04-25,AR,2829,35224,47,38053
2020-04-26,AR,2941,36528,49,39469
2020-04-27,AR,3017,37440,50,40457
2020-04-28,AR,3111,37560,52,40671
2020-04-29,AR,3192,42257,59,45449
2020-04-30,AR,3255,45124,61,48379
2020-05-01,AR,3321,46355,64,49676
2020-05-02,AR,3372,48210,73,51582
2020-05-03,AR,3431,49459,76,52890
2020-05-04,AR,3458,50984,81,54442
2020-05-05,AR,3496,51139,83,54635
2020-05-06,AR,3568,55435,85,59003
2020-05-07,AR,3611,56384,87,59995
2020-05-08,AR,3694,60300,88,63994
2020-05-09,AR,3747,61781,88,65528
2020-05-10,AR,3747,61781,88,65528
2020-05-11,AR,4034,64996,94,69030
2020-05-12,AR,4164,66280,95,70444
2020-05-13,AR,4164,69051,95,73215
2020-05-14,AR,4236,71582,97,75818
2020-05-15,AR,4463,77066,98,81529
2020-05-16,AR,4578,77066,98,81644
2020-05-17,AR,4759,80426,98,85185
2020-05-18,AR,4813,80426,100,85239
2020-05-19,AR,4923,88778,102,93701
2020-05-20,AR,5003,91255,107,96258
2020-05-21,AR,5458,93818,110,99276
2020-05-22,AR,5612,97435,113,103047
2020-05-23,AR,5612,97435,113,103047
2020-05-24,AR,5922,102659,116,108581
2020-05-25,AR,6029,105593,117,111622
2020-05-26,AR,6180,105593,119,111773
2020-05-27,AR,6277,109319,120,115596
2020-05-28,AR,6538,112364,120,118902
2020-05-29,AR,6538,113230,125,119768
2020-05-30,AR,7013,119484,133,126497
2020-05-31,AR,7253,122262,133,129515
2020-06-01,AR,7443,125793,133,133236
2020-06-02,AR,7443,125793,133,133236
2020-06-03,AR,8067,134413,142,142480
2020-06-04,AR,8067,134413,142,142480
2020-06-05,AR,8651,138960,152,147611
2020-06-06,AR,9101,147656,154,156757
2020-06-07,AR,9426,150847,154,160273
2020-06-08,AR,9740,150847,155,160587
2020-06-09,AR,10080,155701,161,165781
2020-06-10,AR,10368,165849,165,176217
2020-06-11,AR,10816,165849,171,176665
2020-06-12,AR,11547,169575,176,181122
2020-06-13,AR,11547,175470,176,187017
2020-06-14,AR,12501,184488,179,196989
2020-06-15,AR,12917,191221,182,204138
2020-06-16,AR,13191,192375,182,205566
2020-06-17,AR,13606,207093,197,220699
2020-06-18,AR,13928,214506,208,228434
2020-06-19,AR,14631,220141,214,234772
2020-06-20,AR,15142,227092,224,242234
2020-06-21,AR,15142,227092,224,242234
2020-06-22,AR,16083,240256,227,256339
2020-06-23,AR,16678,247814,237,264492
2020-06-24,AR,17375,254491,240,271866
2020-06-25,AR,18062,259318,240,277380
2020-06-26,AR,18062,259318,240,277380
2020-06-27,AR,18740,265225,249,283965
2020-06-28,AR,19310,271912,259,291222
2020-06-29,AR,20257,282279,265,302536
2020-06-30,AR,20777,290426,270,311203
2020-07-01,AR,21197,293661,277,314858
2020-07-02,AR,22075,301912,279,323987
2020-07-03,AR,22622,308615,281,331237
2020-07-04,AR,23209,315684,286,338893
2020-07-05,AR,23209,315684,286,338893
2020-07-06,AR,24253,320715,292,344968
2020-07-07,AR,24512,326143,292,350655
2020-07-08,AR,24512,328760,301,353272
2020-07-09,AR,26052,338609,309,364661
2020-07-10,AR,26803,338609,313,365412
2020-07-11,AR,26803,342846,313,369649
2020-07-12,AR,28367,354035,321,382402
2020-07-13,AR,28939,354035,323,382974
2020-07-14,AR,29733,360566,331,390299
2020-07-15,AR,30297,365479,335,395776
2020-07-16,AR,31114,369847,341,400961
2020-07-17,AR,31762,375735,353,407497
2020-07-18,AR,31762,381243,353,413005
2020-07-19,AR,32533,386638,357,419171
2020-07-20,AR,33927,398889,357,432816
2020-07-21,AR,34655,404980,374,439635
2020-07-22,AR,35246,404980,380,440226
2020-07-23,AR,36259,410221,386,446480
2020-03-16,AS,0,0,0,0
2020-03-17,AS,0,0,0,0
2020-03-18,AS,0,0,0,0
2020-03-19,AS,0,0,0,0
2020-03-20,AS,0,0,0,0
2020-03-21,AS,0,0,0,0
2020-03-22,AS,0,0,0,0
2020-03-23,AS,0,0,0,0
2020-03-24,AS,0,0,0,0
2020-03-25,AS,0,0,0,0
2020-03-26,AS,0,0,0,0
2020-03-27,AS,0,0,0,0
2020-03-28,AS,0,0,0,0
2020-03-29,AS,0,0,0,0
2020-03-30,AS,0,0,0,0
2020-03-31,AS,0,3,0,3
2020-04-01,AS,0,3,0,3
2020-04-02,AS,0,3,0,3
2020-04-03,AS,0,3,0,3
2020-04-04,AS,0,3,0,3
2020-04-05,AS,0,3,0,3
2020-04-06,AS,0,3,0,3
2020-04-07,AS,0,3,0,3
2020-04-08,AS,0,3,0,3
2020-04-09,AS,0,3,0,3
2020-04-10,AS,0,3,0,3
2020-04-11,AS,0,3,0,3
2020-04-12,AS,0,3,0,3
2020-04-13,AS,0,3,0,3
2020-04-14,AS,0,3,0,3
2020-04-15,AS,0,3,0,3
2020-04-16,AS,0,3,0,3
2020-04-17,AS,0,3,0,3
2020-04-18,AS,0,3,0,3
2020-04-19,AS,0,3,0,3
2020-04-20,AS,0,3,0,3
2020-04-21,AS,0,3,0,3
2020-04-22,AS,0,3,0,3
2020-04-23,AS,0,3,0,3
2020-04-24,AS,0,3,0,3
2020-04-25,AS,0,3,0,3
2020-04-26,AS,0,3,0,3
2020-04-27,AS,0,3,0,3
2020-04-28,AS,0,3,0,3
2020-04-29,AS,0,3,0,3
2020-04-30,AS,0,3,0,3
2020-05-01,AS,0,57,0,57
2020-05-02,AS,0,57,0,57
2020-05-03,AS,0,57,0,57
2020-05-04,AS,0,83,0,83
2020-05-05,AS,0,83,0,83
2020-05-06,AS,0,83,0,83
2020-05-07,AS,0,83,0,83
2020-05-08,AS,0,83,0,83
2020-05-09,AS,0,83,0,83
2020-05-10,AS,0,83,0,83
2020-05-11,AS,0,105,0,105
2020-05-12,AS,0,105,0,105
2020-05-13,AS,0,105,0,105
2020-05-14,AS,0,105,0,105
2020-05-15,AS,0,105,0,105
2020-05-16,AS,0,105,0,105
2020-05-17,AS,0,105,0,105
2020-05-18,AS,0,105,0,105
2020-05-19,AS,0,124,0,124
2020-05-20,AS,0,124,0,124
2020-05-21,AS,0,124,0,124
2020-05-22,AS,0,124,0,124
2020-05-23,AS,0,124,0,124
2020-05-24,AS,0,124,0,124
2020-05-25,AS,0,124,0,124
2020-05-26,AS,0,124,0,124
2020-05-27,AS,0,174,0,174
2020-05-28,AS,0,174,0,174
2020-05-29,AS,0,174,0,174
2020-05-30,AS,0,174,0,174
2020-05-31,AS,0,174,0,174
2020-06-01,AS,0,174,0,174
2020-06-02,AS,0,174,0,174
2020-06-03,AS,0,174,0,174
2020-06-04,AS,0,174,0,174
2020-06-05,AS,0,174,0,174
2020-06-06,AS,0,174,0,174
2020-06-07,AS,0,174,0,174
2020-06-08,AS,0,174,0,174
2020-06-09,AS,0,174,0,174
2020-06-10,AS,0,174,0,174
2020-06-11,AS,0,174,0,174
2020-06-12,AS,0,174,0,174
2020-06-13,AS,0,174,0,174
2020-06-14,AS,0,174,0,174
2020-06-15,AS,0,174,0,174
2020-06-16,AS,0,174,0,174
2020-06-17,AS,0,174,0,174
2020-06-18,AS,0,174,0,174
2020-06-19,AS,0,174,0,174
2020-06-20,AS,0,174,0,174
2020-06-21,AS,0,174,0,174
2020-06-22,AS,0,174,0,174
2020-06-23,AS,0,174,0,174
2020-06-24,AS,0,174,0,174
2020-06-25,AS,0,696,0,696
2020-06-26,AS,0,696,0,696
2020-06-27,AS,0,696,0,696
2020-06-28,AS,0,696,0,696
2020-06-29,AS,0,696,0,696
2020-06-30,AS,0,696,0,696
2020-07-01,AS,0,696,0,696
2020-07-02,AS,0,696,0,696
2020-07-03,AS,0,696,0,696
2020-07-04,AS,0,696,0,696
2020-07-05,AS,0,696,0,696
2020-07-06,AS,0,696,0,696
2020-07-07,AS,0,696,0,696
2020-07-08,AS,0,816,0,816
2020-07-09,AS,0,816,0,816
2020-07-10,AS,0,816,0,816
2020-07-11,AS,0,816,0,816
2020-07-12,AS,0,816,0,816
2020-07-13,AS,0,816,0,816
2020-07-14,AS,0,816,0,816
2020-07-15,AS,0,816,0,816
2020-07-16,AS,0,1037,0,1037
2020-07-17,AS,0,1037,0,1037
2020-07-18,AS,0,1037,0,1037
2020-07-19,AS,0,1037,0,1037
2020-07-20,AS,0,1037,0,1037
2020-07-21,AS,0,1037,0,1037
2020-07-22,AS,0,1037,0,1037
2020-07-23,AS,0,1037,0,1037
2020-03-04,AZ,2,27,0,29
2020-03-05,AZ,2,28,0,30
2020-03-06,AZ,3,33,0,36
2020-03-07,AZ,5,44,0,49
2020-03-08,AZ,5,44,0,49
2020-03-09,AZ,5,44,0,49
2020-03-10,AZ,6,51,0,57
2020-03-11,AZ,9,59,0,68
2020-03-12,AZ,9,82,0,91
2020-03-13,AZ,9,94,0,103
2020-03-14,AZ,12,121,0,133
2020-03-15,AZ,12,121,0,133
2020-03-16,AZ,18,125,0,143
2020-03-17,AZ,20,142,0,162
2020-03-18,AZ,28,148,0,176
2020-03-19,AZ,44,175,0,219
2020-03-20,AZ,65,211,0,276
2020-03-21,AZ,104,240,1,344
2020-03-22,AZ,152,282,2,434
2020-03-23,AZ,265,309,2,574
2020-03-24,AZ,357,313,5,670
2020-03-25,AZ,450,323,6,773
2020-03-26,AZ,577,347,8,924
2020-03-27,AZ,736,7455,13,8191
2020-03-28,AZ,873,7455,15,8328
2020-03-29,AZ,919,12953,17,13872
2020-03-30,AZ,1157,15602,20,16759
2020-03-31,AZ,1289,18082,24,19371
2020-04-01,AZ,1413,19645,29,21058
2020-04-02,AZ,1598,21111,32,22709
2020-04-03,AZ,1769,22904,41,24673
2020-04-04,AZ,2019,25141,52,27160
2020-04-05,AZ,2269,25141,64,27410
2020-04-06,AZ,2456,30078,65,32534
2020-04-07,AZ,2575,30800,73,33375
2020-04-08,AZ,2726,31838,80,34564
2020-04-09,AZ,3018,34160,89,37178
2020-04-10,AZ,3112,34622,97,37734
2020-04-11,AZ,3393,37137,108,40530
2020-04-12,AZ,3539,38570,115,42109
2020-04-13,AZ,3702,39645,122,43347
2020-04-14,AZ,3806,40290,131,44096
2020-04-15,AZ,3962,41348,142,45310
2020-04-16,AZ,4234,43164,150,47398
2020-04-17,AZ,4507,44723,169,49230
2020-04-18,AZ,4719,46326,177,51045
2020-04-19,AZ,4929,48061,184,52990
2020-04-20,AZ,5064,49436,187,54500
2020-04-21,AZ,5251,49901,208,55152
2020-04-22,AZ,5459,51142,229,56601
2020-04-23,AZ,5769,52928,249,58697
2020-04-24,AZ,6045,54669,266,60714
2020-04-25,AZ,6280,56228,266,62508
2020-04-26,AZ,6526,58285,275,64811
2020-04-27,AZ,6716,59827,275,66543
2020-04-28,AZ,6948,60490,293,67438
2020-04-29,AZ,7202,61611,304,68813
2020-04-30,AZ,7648,64138,320,71786
2020-05-01,AZ,7962,66917,330,74879
2020-05-02,AZ,8364,69633,348,77997
2020-05-03,AZ,8640,72479,362,81119
2020-05-04,AZ,8919,76334,362,85253
2020-05-05,AZ,9305,78955,395,88260
2020-05-06,AZ,9707,82030,426,91737
2020-05-07,AZ,9945,86489,450,96434
2020-05-08,AZ,10526,90599,517,101125
2020-05-09,AZ,10960,94850,532,105810
2020-05-10,AZ,11119,99258,536,110377
2020-05-11,AZ,11380,105084,542,116464
2020-05-12,AZ,11736,111106,562,122842
2020-05-13,AZ,12176,115574,594,127750
2020-05-14,AZ,12674,121664,624,134338
2020-05-15,AZ,13169,128832,651,142001
2020-05-16,AZ,13631,133157,679,146788
2020-05-17,AZ,13937,137824,680,151761
2020-05-18,AZ,14170,142303,686,156473
2020-05-19,AZ,14566,147005,704,161571
2020-05-20,AZ,14897,150538,747,165435
2020-05-21,AZ,15315,156312,763,171627
2020-05-22,AZ,15608,160395,775,176003
2020-05-23,AZ,16039,164400,799,180439
2020-05-24,AZ,16339,167302,800,183641
2020-05-25,AZ,16561,171221,806,187782
2020-05-26,AZ,16783,173948,807,190731
2020-05-27,AZ,17262,179004,831,196266
2020-05-28,AZ,17763,185151,857,202914
2020-05-29,AZ,18465,191348,885,209813
2020-05-30,AZ,19255,197792,903,217047
2020-05-31,AZ,19936,205270,906,225206
2020-06-01,AZ,20123,207947,917,228070
2020-06-02,AZ,21250,216583,941,237833
2020-06-03,AZ,22233,222292,981,244525
2020-06-04,AZ,22753,227002,996,249755
2020-06-05,AZ,24332,239533,1012,263865
2020-06-06,AZ,25451,246195,1042,271646
2020-06-07,AZ,26889,254732,1044,281621
2020-06-08,AZ,27678,260403,1047,288081
2020-06-09,AZ,28296,264917,1070,293213
2020-06-10,AZ,29852,269835,1095,299687
2020-06-11,AZ,31264,278318,1127,309582
2020-06-12,AZ,32918,289861,1144,322779
2020-06-13,AZ,34458,293939,1183,328397
2020-06-14,AZ,35691,302354,1186,338045
2020-06-15,AZ,36705,308552,1194,345257
2020-06-16,AZ,39097,315237,1219,354334
2020-06-17,AZ,40924,325269,1239,366193
2020-06-18,AZ,43443,336289,1271,379732
2020-06-19,AZ,46689,345527,1312,392216
2020-06-20,AZ,49798,355482,1338,405280
2020-06-21,AZ,52390,367354,1339,419744
2020-06-22,AZ,54586,375204,1342,429790
2020-06-23,AZ,58179,382339,1384,440518
2020-06-24,AZ,59974,389214,1463,449188
2020-06-25,AZ,63030,401166,1490,464196
2020-06-26,AZ,66548,413275,1535,479823
2020-06-27,AZ,70051,424696,1579,494747
2020-06-28,AZ,73908,435988,1588,509896
2020-06-29,AZ,74533,436890,1588,511423
2020-06-30,AZ,79215,453141,1632,532356
2020-07-01,AZ,84092,465504,1720,549596
2020-07-02,AZ,87425,473414,1757,560839
2020-07-03,AZ,91858,486523,1788,578381
2020-07-04,AZ,94553,494955,1805,589508
2020-07-05,AZ,98089,506273,1809,604362
2020-07-06,AZ,101441,516400,1810,617841
2020-07-07,AZ,105094,523703,1927,628797
2020-07-08,AZ,108614,532456,1963,641070
2020-07-09,AZ,112671,540390,2038,653061
2020-07-10,AZ,116892,552319,2082,669211
2020-07-11,AZ,119930,564060,2151,683990
2020-07-12,AZ,122467,573705,2237,696172
2020-07-13,AZ,123824,578602,2245,702426
2020-07-14,AZ,128097,593846,2337,721943
2020-07-15,AZ,131354,604608,2434,735962
2020-07-16,AZ,134613,614653,2492,749266
2020-07-17,AZ,138523,626445,2583,764968
2020-07-18,AZ,141265,630726,2730,771991
2020-07-19,AZ,143624,642355,2761,785979
2020-07-20,AZ,145183,648340,2784,793523
2020-07-21,AZ,148683,658983,2918,807666
2020-07-22,AZ,150609,663372,2974,813981
2020-07-23,AZ,152944,669769,3063,822713
2020-03-04,CA,53,462,0,515
2020-03-05,CA,53,462,0,515
2020-03-06,CA,60,462,0,522
2020-03-07,CA,69,462,0,531
2020-03-08,CA,88,462,0,550
2020-03-09,CA,114,690,0,804
2020-03-10,CA,133,690,0,823
2020-03-11,CA,157,916,0,1073
2020-03-12,CA,202,916,4,1118
2020-03-13,CA,202,916,4,1118
2020-03-14,CA,252,916,5,1168
2020-03-15,CA,293,916,5,1209
2020-03-16,CA,335,7981,6,8316
2020-03-17,CA,483,7981,11,8464
2020-03-18,CA,611,7981,13,8592
2020-03-19,CA,924,8787,18,9711
2020-03-20,CA,1063,10424,20,11487
2020-03-21,CA,1279,11249,24,12528
2020-03-22,CA,1536,11304,27,12840
2020-03-23,CA,1733,12567,27,14300
2020-03-24,CA,2102,13452,40,15554
2020-03-25,CA,2355,15921,53,18276
2020-03-26,CA,3006,17380,65,20386
2020-03-27,CA,3879,17380,78,21259
2020-03-28,CA,4643,20549,101,25192
2020-03-29,CA,5708,20549,123,26257
2020-03-30,CA,6447,20549,133,26996
2020-03-31,CA,7482,21772,153,29254
2020-04-01,CA,8155,21772,171,29927
2020-04-02,CA,9191,23809,203,33000
2020-04-03,CA,10701,24599,237,35300
2020-04-04,CA,12026,101674,276,113700
2020-04-05,CA,13438,103095,319,116533
2020-04-06,CA,14336,103095,343,117431
2020-04-07,CA,15865,115364,374,131229
2020-04-08,CA,16957,127307,442,144264
2020-04-09,CA,18309,145191,492,163500
2020-04-10,CA,19472,145391,541,164863
2020-04-11,CA,20615,152604,609,173219
2020-04-12,CA,21794,168534,651,190328
2020-04-13,CA,22348,168534,687,190882
2020-04-14,CA,23338,178870,758,202208
2020-04-15,CA,24424,192062,821,216486
2020-04-16,CA,26182,220218,890,246400
2020-04-17,CA,27528,224086,985,251614
2020-04-18,CA,28963,230703,1072,259666
2020-04-19,CA,30333,250567,1166,280900
2020-04-20,CA,30978,259522,1208,290500
2020-04-21,CA,33261,266839,1268,300100
2020-04-22,CA,35396,429931,1354,465327
2020-04-23,CA,37369,444728,1469,482097
2020-04-24,CA,39254,454919,1562,494173
2020-04-25,CA,41137,464898,1651,506035
2020-04-26,CA,42164,483920,1710,526084
2020-04-27,CA,43464,509945,1755,553409
2020-04-28,CA,45031,532577,1809,577608
2020-04-29,CA,46500,556639,1887,603139
2020-04-30,CA,48917,576420,1982,625337
2020-05-01,CA,50442,604543,2073,654985
2020-05-02,CA,52197,634606,2171,686803
2020-05-03,CA,53616,662135,2215,715751
2020-05-04,CA,54937,692937,2254,747874
2020-05-05,CA,56212,723690,2317,779902
2020-05-06,CA,58815,750221,2412,809036
2020-05-07,CA,60614,782260,2504,842874
2020-05-08,CA,62512,812760,2585,875272
2020-05-09,CA,64561,848009,2678,912570
2020-05-10,CA,66680,888984,2745,955664
2020-05-11,CA,67939,923958,2770,991897
2020-05-12,CA,69382,963988,2847,1033370
2020-05-13,CA,71141,994451,2934,1065592
2020-05-14,CA,73164,1031487,3032,1104651
2020-05-15,CA,74936,1058970,3108,1133906
2020-05-16,CA,76793,1102333,3204,1179126
2020-05-17,CA,78839,1156404,3261,1235243
2020-05-18,CA,80430,1212242,3302,1292672
2020-05-19,CA,81795,1257521,3334,1339316
2020-05-20,CA,84057,1296063,3436,1380120
2020-05-21,CA,86197,1334930,3542,1421127
2020-05-22,CA,88444,1378329,3630,1466773
2020-05-23,CA,90631,1424675,3708,1515306
2020-05-24,CA,92710,1490035,3774,1582745
2020-05-25,CA,94558,1549544,3795,1644102
2020-05-26,CA,96733,1599663,3814,1696396
2020-05-27,CA,98980,1637914,3884,1736894
2020-05-28,CA,101697,1688862,3973,1790559
2020-05-29,CA,103886,1731592,4068,1835478
2020-05-30,CA,106878,1781717,4156,1888595
2020-05-31,CA,110583,1834265,4213,1944848
2020-06-01,CA,113006,1899577,4251,2012583
2020-06-02,CA,115310,1956281,4286,2071591
2020-06-03,CA,117687,2013607,4361,2131294
2020-06-04,CA,119807,2062864,4422,2182671
2020-06-05,CA,122901,2115562,4485,2238463
2020-06-06,CA,126016,2182284,4559,2308300
2020-06-07,CA,128812,2233406,4626,2362218
2020-06-08,CA,131319,2299871,4653,2431190
2020-06-09,CA,133489,2352756,4697,2486245
2020-06-10,CA,136191,2404607,4776,2540798
2020-06-11,CA,139281,2458366,4881,2597647
2020-06-12,CA,141983,2520275,4943,2662258
2020-06-13,CA,145643,2578750,4989,2724393
2020-06-14,CA,148855,2653141,5063,2801996
2020-06-15,CA,151452,2716730,5089,2868182
2020-06-16,CA,153560,2784195,5121,2937755
2020-06-17,CA,157015,2840973,5208,2997988
2020-06-18,CA,161099,2913431,5290,3074530
2020-06-19,CA,165416,2990286,5360,3155702
2020-06-20,CA,169309,3065103,5424,3234412
2020-06-21,CA,173824,3145432,5495,3319256
2020-06-22,CA,178054,3233632,5515,3411686
2020-06-23,CA,183073,3313856,5580,3496929
2020-06-24,CA,190222,3402677,5632,3592899
2020-06-25,CA,195571,3498774,5733,3694345
2020-06-26,CA,200461,3570853,5812,3771314
2020-06-27,CA,206433,3655877,5872,3862310
2020-06-28,CA,211243,3744709,5905,3955952
2020-06-29,CA,219252,3842440,5936,4061692
2020-06-30,CA,228732,3938407,5980,4167139
2020-07-01,CA,236139,4018037,6090,4254176
2020-07-02,CA,242547,4096171,6163,4338718
2020-07-03,CA,248235,4199941,6263,4448176
2020-07-04,CA,257388,4295643,6313,4553031
2020-07-05,CA,265985,4414153,6331,4680138
2020-07-06,CA,271684,4521669,6337,4793353
2020-07-07,CA,277774,4618596,6448,4896370
2020-07-08,CA,289468,4706707,6562,4996175
2020-07-09,CA,296499,4781935,6711,5078434
2020-07-10,CA,304297,4871440,6851,5175737
2020-07-11,CA,312344,4963351,6945,5275695
2020-07-12,CA,320804,5085795,7017,5406599
2020-07-13,CA,329162,5215203,7040,5544365
2020-07-14,CA,336508,5338447,7087,5674955
2020-07-15,CA,347634,5445642,7227,5793276
2020-07-16,CA,356178,5559330,7345,5915508
2020-07-17,CA,366164,5677935,7475,6044099
2020-07-18,CA,375363,5791855,7595,6167218
2020-07-19,CA,384692,5902160,7685,6286852
2020-07-20,CA,391538,6022783,7694,6414321
2020-07-21,CA,400769,6136163,7755,6536932
2020-07-22,CA,413576,6250843,7870,6664419
2020-07-23,CA,425616,6352688,8027,6778304
2020-03-05,CO,0,19,0,19
2020-03-06,CO,2,46,0,48
2020-03-07,CO,8,55,0,63
2020-03-08,CO,8,104,0,112
2020-03-09,CO,9,133,0,142
2020-03-10,CO,12,142,0,154
2020-03-11,CO,28,251,0,279
2020-03-12,CO,45,298,0,343
2020-03-13,CO,72,524,0,596
2020-03-14,CO,101,610,1,711
2020-03-15,CO,131,627,1,758
2020-03-16,CO,131,627,1,758
2020-03-17,CO,160,1056,1,1216
2020-03-18,CO,183,1617,2,1800
2020-03-19,CO,216,2112,2,2328
2020-03-20,CO,277,2675,3,2952
2020-03-21,CO,363,3317,4,3680
2020-03-22,CO,475,4075,5,4550
2020-03-23,CO,591,4845,6,5436
2020-03-24,CO,720,5504,7,6224
2020-03-25,CO,912,6789,11,7701
2020-03-26,CO,1086,6978,19,8064
2020-03-27,CO,1430,8692,24,10122
2020-03-28,CO,1734,9942,31,11676
2020-03-29,CO,2061,11215,44,13276
2020-03-30,CO,2627,12737,51,15364
2020-03-31,CO,2627,12737,51,15364
2020-04-01,CO,2966,13883,69,16849
2020-04-02,CO,3342,15303,80,18645
2020-04-03,CO,3728,16683,97,20411
2020-04-04,CO,4173,17898,111,22071
2020-04-05,CO,4565,19335,126,23900
2020-04-06,CO,4950,20823,140,25773
2020-04-07,CO,5172,21703,150,26875
2020-04-08,CO,5429,22665,179,28094
2020-04-09,CO,5655,23544,193,29199
2020-04-10,CO,6510,26143,250,32653
2020-04-11,CO,6510,26143,250,32653
2020-04-12,CO,6893,27980,274,34873
2020-04-13,CO,7684,29850,304,37534
2020-04-14,CO,7691,31051,308,38742
2020-04-15,CO,7941,31639,329,39580
2020-04-16,CO,8280,32253,357,40533
2020-04-17,CO,8675,33155,374,41830
2020-04-18,CO,9047,34260,391,43307
2020-04-19,CO,9433,35173,411,44606
2020-04-20,CO,9730,36465,422,46195
2020-04-21,CO,10106,37360,449,47466
2020-04-22,CO,10447,38257,486,48704
2020-04-23,CO,10878,39767,508,50645
2020-04-24,CO,11262,41062,552,52324
2020-04-25,CO,12256,44533,674,56789
2020-04-26,CO,12968,46823,672,59791
2020-04-27,CO,13441,49833,680,63274
2020-04-28,CO,13879,52462,706,66341
2020-04-29,CO,14735,54714,760,69449
2020-04-30,CO,14758,56301,766,71059
2020-05-01,CO,15284,57106,777,72390
2020-05-02,CO,15768,61181,820,76949
2020-05-03,CO,16225,63681,832,79906
2020-05-04,CO,16635,66455,842,83090
2020-05-05,CO,16907,68097,851,85004
2020-05-06,CO,17364,68612,903,85976
2020-05-07,CO,17830,73517,921,91347
2020-05-08,CO,18801,75735,961,94536
2020-05-09,CO,18827,77945,960,96772
2020-05-10,CO,19703,84374,967,104077
2020-05-11,CO,19899,88891,981,108790
2020-05-12,CO,19879,88778,987,108657
2020-05-13,CO,20157,91093,1009,111250
2020-05-14,CO,20475,94044,1062,114519
2020-05-15,CO,20838,97192,1091,118030
2020-05-16,CO,21232,100608,878,121840
2020-05-17,CO,21633,103915,878,125548
2020-05-18,CO,21938,106557,878,128495
2020-05-19,CO,22202,109131,921,131333
2020-05-20,CO,22482,109355,968,131837
2020-05-21,CO,22797,112814,1001,135611
2020-05-22,CO,23191,119034,1062,142225
2020-05-23,CO,23487,121465,1088,144952
2020-05-24,CO,23964,126087,1088,150051
2020-05-25,CO,24174,126134,1088,150308
2020-05-26,CO,24269,131742,1088,156011
2020-05-27,CO,24565,134855,1114,159420
2020-05-28,CO,24767,138356,1135,163123
2020-05-29,CO,25121,143838,1168,168959
2020-05-30,CO,25613,150128,1181,175741
2020-05-31,CO,26098,154529,1181,180627
2020-06-01,CO,26378,159998,1181,186376
2020-06-02,CO,26577,163960,1185,190537
2020-06-03,CO,26788,167389,1228,194177
2020-06-04,CO,27060,170140,1254,197200
2020-06-05,CO,27360,176064,1255,203424
2020-06-06,CO,27615,180662,1274,208277
2020-06-07,CO,27848,185166,1274,213014
2020-06-08,CO,28001,189483,1274,217484
2020-06-09,CO,28183,193704,1292,221887
2020-06-10,CO,28347,197747,1312,226094
2020-06-11,CO,28499,201846,1328,230345
2020-06-12,CO,28647,205723,1339,234370
2020-06-13,CO,28822,207639,1348,236461
2020-06-14,CO,29017,215626,1348,244643
2020-06-15,CO,29130,219955,1348,249085
2020-06-16,CO,29299,223857,1373,253156
2020-06-17,CO,29442,227225,1373,256667
2020-06-18,CO,29673,232543,1402,262216
2020-06-19,CO,29901,234545,1417,264446
2020-06-20,CO,30187,242882,1429,273069
2020-06-21,CO,30349,248037,1429,278386
2020-06-22,CO,30539,252233,1429,282772
2020-06-23,CO,30705,257171,1438,287876
2020-06-24,CO,30893,259941,1455,290834
2020-06-25,CO,31155,264910,1457,296065
2020-06-26,CO,31479,271098,1475,302577
2020-06-27,CO,31796,275787,1482,307583
2020-06-28,CO,32022,281689,1482,313711
2020-06-29,CO,32307,287258,1482,319565
2020-06-30,CO,32511,291346,1508,323857
2020-07-01,CO,32715,294788,1520,327503
2020-07-02,CO,33029,300226,1520,333255
2020-07-03,CO,33352,306938,1521,340290
2020-07-04,CO,33619,312135,1521,345754
2020-07-05,CO,33866,316851,1521,350717
2020-07-06,CO,34065,321590,1521,355655
2020-07-07,CO,34257,326383,1542,360640
2020-07-08,CO,34664,330409,1542,365073
2020-07-09,CO,35116,335586,1544,370702
2020-07-10,CO,35525,341615,1581,377140
2020-07-11,CO,36191,349670,1586,385861
2020-07-12,CO,36591,355512,1586,392103
2020-07-13,CO,36913,362452,1586,399365
2020-07-14,CO,37242,367713,1589,404955
2020-07-15,CO,37686,372304,1594,409990
2020-07-16,CO,38155,378061,1601,416216
2020-07-17,CO,38726,385623,1615,424349
2020-07-18,CO,39344,391439,1615,430783
2020-07-19,CO,39788,396150,1615,435938
2020-07-20,CO,40142,402027,1615,442169
2020-07-21,CO,40566,410733,1615,451299
2020-07-22,CO,41059,416343,1643,457402
2020-07-23,CO,41698,423713,1643,465411
2020-03-07,CT,0,0,0,0
2020-03-08,CT,1,29,0,30
2020-03-09,CT,1,46,0,47
2020-03-10,CT,2,54,0,56
2020-03-11,CT,3,71,0,74
2020-03-12,CT,6,89,0,95
2020-03-13,CT,6,99,0,105
2020-03-14,CT,11,125,0,136
2020-03-15,CT,20,125,0,145
2020-03-16,CT,26,125,0,151
2020-03-17,CT,41,125,0,166
2020-03-18,CT,68,125,0,193
2020-03-19,CT,96,604,1,700
2020-03-20,CT,194,604,3,798
2020-03-21,CT,194,2106,4,2300
2020-03-22,CT,223,2877,5,3100
2020-03-23,CT,415,4085,10,4500
2020-03-24,CT,618,4682,12,5300
2020-03-25,CT,875,5023,19,5898
2020-03-26,CT,1012,5625,21,6637
2020-03-27,CT,1291,7109,27,8400
2020-03-28,CT,1291,7109,27,8400
2020-03-29,CT,1993,9907,34,11900
2020-03-30,CT,2571,12029,36,14600
2020-03-31,CT,3128,13029,69,16157
2020-04-01,CT,3557,13043,85,16600
2020-04-02,CT,3824,14476,112,18300
2020-04-03,CT,4914,15101,131,20015
2020-04-04,CT,5276,16753,165,22029
2020-04-05,CT,5675,17595,189,23270
2020-04-06,CT,6906,19780,206,26686
2020-04-07,CT,7781,21255,277,29036
2020-04-08,CT,7781,21255,277,29036
2020-04-09,CT,9784,23718,380,33502
2020-04-10,CT,10538,25750,448,36288
2020-04-11,CT,11510,28321,494,39831
2020-04-12,CT,12035,29185,554,41220
2020-04-13,CT,13381,30928,602,44309
2020-04-14,CT,13989,31852,671,45841
2020-04-15,CT,14755,35388,868,50143
2020-04-16,CT,15884,37238,971,53122
2020-04-17,CT,16809,38653,1036,55462
2020-04-18,CT,16809,38653,1036,55462
2020-04-19,CT,17550,40663,1086,58213
2020-04-20,CT,19815,42991,1331,62806
2020-04-21,CT,20360,43832,1423,64192
2020-04-22,CT,22469,47449,1544,69918
2020-04-23,CT,23100,48397,1639,71497
2020-04-24,CT,23921,50117,1764,74038
2020-04-25,CT,24582,53020,1862,77602
2020-04-26,CT,25269,54542,1924,79811
2020-04-27,CT,25269,54542,1998,79811
2020-04-28,CT,26312,66433,2089,92745
2020-04-29,CT,26767,68051,2168,94818
2020-04-30,CT,27700,69433,2257,97133
2020-05-01,CT,28764,71493,2339,100257
2020-05-02,CT,28764,71493,2339,100257
2020-05-03,CT,29287,73206,2436,102493
2020-05-04,CT,29287,73206,2495,102493
2020-05-05,CT,30621,78022,2633,108643
2020-05-06,CT,30995,80452,2718,111447
2020-05-07,CT,31784,84390,2797,116174
2020-05-08,CT,32411,88130,2874,120541
2020-05-09,CT,32984,90585,2932,123569
2020-05-10,CT,33554,96638,2967,130192
2020-05-11,CT,33765,98743,3008,132508
2020-05-12,CT,34333,104091,3041,138424
2020-05-13,CT,34855,108088,3125,142943
2020-05-14,CT,35464,114098,3219,149562
2020-05-15,CT,36085,119823,3285,155908
2020-05-16,CT,36703,128052,3339,164755
2020-05-17,CT,37419,133188,3408,170607
2020-05-18,CT,38116,139563,3449,177679
2020-05-19,CT,38430,147090,3472,185520
2020-05-20,CT,39017,151701,3529,190718
2020-05-21,CT,39208,157239,3582,196447
2020-05-22,CT,39640,162688,3637,202328
2020-05-23,CT,40022,168345,3675,208367
2020-05-24,CT,40468,173668,3693,214136
2020-05-25,CT,40873,180853,3742,221726
2020-05-26,CT,41303,184059,3769,225362
2020-05-27,CT,41288,187581,3803,228869
2020-05-28,CT,41559,193966,3826,235525
2020-05-29,CT,41762,199631,3868,241393
2020-05-30,CT,42022,204913,3912,246935
2020-05-31,CT,42201,207845,3944,250046
2020-06-01,CT,42740,218650,3964,261390
2020-06-02,CT,42979,227631,3972,270610
2020-06-03,CT,43091,233345,3989,276436
2020-06-04,CT,43239,238286,4007,281525
2020-06-05,CT,43460,243927,4038,287387
2020-06-06,CT,43818,259611,4055,303429
2020-06-07,CT,43968,265055,4071,309023
2020-06-08,CT,44092,269603,4084,313695
2020-06-09,CT,44179,273843,4097,318022
2020-06-10,CT,44347,278657,4120,323004
2020-06-11,CT,44461,286610,4146,331071
2020-06-12,CT,44689,300443,4159,345132
2020-06-13,CT,44994,305173,4186,350167
2020-06-14,CT,45088,312263,4201,357351
2020-06-15,CT,45235,317038,4204,362273
2020-06-16,CT,45349,323359,4210,368708
2020-06-17,CT,45429,327850,4219,373279
2020-06-18,CT,45440,334853,4226,380293
2020-06-19,CT,45557,346531,4238,392088
2020-06-20,CT,45715,350172,4251,395887
2020-06-21,CT,45755,352175,4260,397930
2020-06-22,CT,45782,358499,4263,404281
2020-06-23,CT,45899,356898,4277,402797
2020-06-24,CT,45913,363357,4287,409270
2020-06-25,CT,45994,371126,4298,417120
2020-06-26,CT,46059,383765,4307,429824
2020-06-27,CT,46206,392824,4311,439030
2020-06-28,CT,46303,399057,4316,445360
2020-06-29,CT,46362,420460,4320,466822
2020-06-30,CT,46514,431844,4322,478358
2020-07-01,CT,46572,443237,4324,489809
2020-07-02,CT,46646,453468,4326,500114
2020-07-03,CT,46717,453369,4335,500086
2020-07-04,CT,46717,453309,4335,500026
2020-07-05,CT,46717,477851,4335,524568
2020-07-06,CT,46976,483537,4338,530513
2020-07-07,CT,47033,490793,4338,537826
2020-07-08,CT,47108,498895,4343,546003
2020-07-09,CT,47209,511233,4348,558442
2020-07-10,CT,47287,511174,4348,558461
2020-07-11,CT,47287,511101,4348,558388
2020-07-12,CT,47287,542107,4348,589394
2020-07-13,CT,47510,544470,4371,591980
2020-07-14,CT,47530,556593,4372,604123
2020-07-15,CT,47636,568022,4380,615658
2020-07-16,CT,47750,582333,4389,630083
2020-07-17,CT,47893,582215,4396,630108
2020-07-18,CT,47893,582076,4396,629969
2020-07-19,CT,47893,609238,4396,657131
2020-07-20,CT,48055,614741,4406,662796
2020-07-21,CT,48096,614741,4406,662837
2020-07-22,CT,48223,626183,4406,674406
2020-07-23,CT,48232,639656,4410,687888
2020-03-05,DC,0,6,0,6
2020-03-06,DC,0,8,0,8
2020-03-07,DC,0,8,0,8
2020-03-08,DC,1,10,0,11
2020-03-09,DC,1,14,0,15
2020-03-10,DC,5,17,0,22
2020-03-11,DC,5,20,0,25
2020-03-12,DC,10,20,0,30
2020-03-13,DC,10,20,0,30
2020-03-14,DC,10,49,0,59
2020-03-15,DC,16,79,0,95
2020-03-16,DC,17,96,0,113
2020-03-17,DC,22,104,0,126
2020-03-18,DC,31,138,0,169
2020-03-19,DC,39,153,0,192
2020-03-20,DC,71,501,1,572
2020-03-21,DC,77,506,1,583
2020-03-22,DC,98,957,1,1055
2020-03-23,DC,116,1113,2,1229
2020-03-24,DC,137,1195,2,1332
2020-03-25,DC,183,1423,2,1606
2020-03-26,DC,231,1626,3,1857
2020-03-27,DC,267,1897,3,2164
2020-03-28,DC,304,2211,4,2515
2020-03-29,DC,342,2469,5,2811
2020-03-30,DC,401,2682,9,3083
2020-03-31,DC,495,3262,9,3757
2020-04-01,DC,586,3262,11,3848
2020-04-02,DC,653,4417,12,5070
2020-04-03,DC,757,4827,15,5584
2020-04-04,DC,902,5536,21,6438
2020-04-05,DC,998,5836,22,6834
2020-04-06,DC,1097,6356,24,7453
2020-04-07,DC,1211,6612,22,7823
2020-04-08,DC,1440,6843,27,8283
2020-04-09,DC,1523,7201,32,8724
2020-04-10,DC,1660,7695,38,9355
2020-04-11,DC,1778,8261,47,10039
2020-04-12,DC,1875,8765,50,10640
2020-04-13,DC,1955,8979,53,10934
2020-04-14,DC,2058,9226,67,11284
2020-04-15,DC,2197,9328,72,11525
2020-04-16,DC,2350,9800,81,12150
2020-04-17,DC,2476,10167,86,12643
2020-04-18,DC,2666,10602,91,13268
2020-04-19,DC,2793,10906,96,13699
2020-04-20,DC,2927,11186,105,14113
2020-04-21,DC,3098,11841,112,14939
2020-04-22,DC,3206,12296,127,15502
2020-04-23,DC,3361,12569,139,15930
2020-04-24,DC,3528,13005,153,16533
2020-04-25,DC,3699,13603,165,17302
2020-04-26,DC,3841,14227,178,18068
2020-04-27,DC,3892,14524,185,18416
2020-04-28,DC,3994,14891,190,18885
2020-04-29,DC,4106,15123,205,19229
2020-04-30,DC,4323,15756,224,20079
2020-05-01,DC,4658,16477,231,21135
2020-05-02,DC,4797,17207,240,22004
2020-05-03,DC,5016,18086,251,23102
2020-05-04,DC,5170,18625,258,23795
2020-05-05,DC,5322,19007,264,24329
2020-05-06,DC,5461,19523,277,24984
2020-05-07,DC,5654,20202,285,25856
2020-05-08,DC,5899,21216,304,27115
2020-05-09,DC,6102,22081,311,28183
2020-05-10,DC,6272,23298,323,29570
2020-05-11,DC,6389,23872,328,30261
2020-05-12,DC,6485,24565,336,31050
2020-05-13,DC,6584,25074,350,31658
2020-05-14,DC,6736,26263,358,32999
2020-05-15,DC,6871,27468,368,34339
2020-05-16,DC,7042,28490,375,35532
2020-05-17,DC,7123,29403,383,36526
2020-05-18,DC,7270,30555,392,37825
2020-05-19,DC,7434,31940,400,39374
2020-05-20,DC,7551,32868,407,40419
2020-05-21,DC,7788,33968,412,41756
2020-05-22,DC,7893,35100,418,42993
2020-05-23,DC,7966,44025,427,51991
2020-05-24,DC,7966,44025,427,51991
2020-05-25,DC,8225,32578,440,40803
2020-05-26,DC,8334,33721,440,42055
2020-05-27,DC,8406,34291,445,42697
2020-05-28,DC,8492,35022,453,43514
2020-05-29,DC,8538,35320,460,43858
2020-05-30,DC,8717,36912,462,45629
2020-05-31,DC,8801,37682,466,46483
2020-06-01,DC,8857,38406,468,47263
2020-06-02,DC,8886,38815,470,47701
2020-06-03,DC,9016,40546,473,49562
2020-06-04,DC,9120,41976,475,51096
2020-06-05,DC,9199,42662,475,51861
2020-06-06,DC,9269,44409,483,53678
2020-06-07,DC,9332,45215,489,54547
2020-06-08,DC,9389,46377,491,55766
2020-06-09,DC,9474,47678,495,57152
2020-06-10,DC,9537,48655,499,58192
2020-06-11,DC,9589,49699,502,59288
2020-06-12,DC,9654,52299,506,61953
2020-06-13,DC,9709,53327,511,63036
2020-06-14,DC,9767,54763,515,64530
2020-06-15,DC,9799,56047,515,65846
2020-06-16,DC,9818,57308,520,67126
2020-06-17,DC,9847,60239,523,70086
2020-06-18,DC,9903,62296,527,72199
2020-06-19,DC,9952,63839,530,73791
2020-06-20,DC,9984,67969,531,77953
2020-06-21,DC,10020,69502,533,79522
2020-06-22,DC,10058,71946,535,82004
2020-06-23,DC,10094,73208,537,83302
2020-06-24,DC,10128,74045,541,84173
2020-06-25,DC,10159,76572,543,86731
2020-06-26,DC,10185,77938,546,88123
2020-06-27,DC,10216,79055,548,89271
2020-06-28,DC,10248,82884,550,93132
2020-06-29,DC,10292,85068,551,95360
2020-06-30,DC,10327,86968,551,97295
2020-07-01,DC,10365,89670,553,100035
2020-07-02,DC,10390,90673,554,101063
2020-07-03,DC,10435,92374,555,102809
2020-07-04,DC,10447,94107,557,104554
2020-07-05,DC,10482,95511,559,105993
2020-07-06,DC,10515,97135,561,107650
2020-07-07,DC,10569,99808,561,110377
2020-07-08,DC,10642,103647,564,114289
2020-07-09,DC,10679,105244,568,115923
2020-07-10,DC,10743,110141,568,120884
2020-07-11,DC,10801,113249,568,124050
2020-07-12,DC,10847,116036,568,126883
2020-07-13,DC,10906,119314,568,130220
2020-07-14,DC,10946,122970,568,133916
2020-07-15,DC,11026,126918,571,137944
2020-07-16,DC,11076,129166,574,140242
2020-07-17,DC,11115,130492,577,141607
2020-07-18,DC,11194,133761,578,144955
2020-07-19,DC,11261,136504,578,147765
2020-07-20,DC,11339,140401,579,151740
2020-07-21,DC,11427,144284,580,155711
2020-07-22,DC,11529,148043,580,159572
2020-07-23,DC,11571,150450,581,162021
2020-03-06,DE,0,10,0,10
2020-03-07,DE,0,10,0,10
2020-03-08,DE,0,10,0,10
2020-03-09,DE,0,15,0,15
2020-03-10,DE,0,17,0,17
2020-03-11,DE,1,17,0,18
2020-03-12,DE,4,23,0,27
2020-03-13,DE,4,30,0,34
2020-03-14,DE,6,36,0,42
2020-03-15,DE,6,36,0,42
2020-03-16,DE,8,36,0,44
2020-03-17,DE,16,36,0,52
2020-03-18,DE,25,36,0,61
2020-03-19,DE,30,36,0,66
2020-03-20,DE,38,36,0,74
2020-03-21,DE,45,36,0,81
2020-03-22,DE,56,36,0,92
2020-03-23,DE,68,36,0,104
2020-03-24,DE,91,36,1,127
2020-03-25,DE,115,36,2,151
2020-03-26,DE,130,36,3,166
2020-03-27,DE,163,36,5,199
2020-03-28,DE,214,36,9,250
2020-03-29,DE,232,36,10,268
2020-03-30,DE,264,2216,11,2480
2020-03-31,DE,319,3696,12,4015
2020-04-01,DE,368,4015,13,4383
2020-04-02,DE,393,4566,16,4959
2020-04-03,DE,450,4995,17,5445
2020-04-04,DE,593,5874,17,6467
2020-04-05,DE,673,6321,19,6994
2020-04-06,DE,673,6321,24,6994
2020-04-07,DE,928,7628,28,8556
2020-04-08,DE,928,7628,32,8556
2020-04-09,DE,1207,8683,34,9890
2020-04-10,DE,1326,10415,36,11741
2020-04-11,DE,1479,9624,43,11103
2020-04-12,DE,1479,9624,48,11103
2020-04-13,DE,1625,10195,53,11820
2020-04-14,DE,1761,10543,60,12304
2020-04-15,DE,2014,11088,67,13102
2020-04-16,DE,2075,11275,70,13350
2020-04-17,DE,2323,11694,76,14017
2020-04-18,DE,2323,11694,86,14017
2020-04-19,DE,2538,12256,90,14794
2020-04-20,DE,2745,12508,99,15253
2020-04-21,DE,2931,12935,104,15866
2020-04-22,DE,3200,13353,117,16553
2020-04-23,DE,3308,13604,131,16912
2020-04-24,DE,3442,13937,147,17379
2020-04-25,DE,3576,14122,155,17698
2020-04-26,DE,4034,15215,168,19249
2020-04-27,DE,4162,15454,181,19616
2020-04-28,DE,4575,16605,192,21180
2020-04-29,DE,4655,16883,204,21538
2020-04-30,DE,4734,17086,210,21820
2020-05-01,DE,4918,17667,222,22585
2020-05-02,DE,5038,18074,235,23112
2020-05-03,DE,5208,18529,246,23737
2020-05-04,DE,5288,18822,255,24110
2020-05-05,DE,5371,19309,266,24680
2020-05-06,DE,5778,20690,269,26468
2020-05-07,DE,5939,21387,285,27326
2020-05-08,DE,6111,22153,297,28264
2020-05-09,DE,6277,23019,301,29296
2020-05-10,DE,6447,24592,312,31039
2020-05-11,DE,6565,25363,324,31928
2020-05-12,DE,6741,26550,334,33291
2020-05-13,DE,6952,27801,351,34753
2020-05-14,DE,7223,29634,362,36857
2020-05-15,DE,7373,30905,373,38278
2020-05-16,DE,7547,32211,383,39758
2020-05-17,DE,7670,33195,392,40865
2020-05-18,DE,7869,34589,399,42458
2020-05-19,DE,8037,36095,408,44132
2020-05-20,DE,8194,37218,414,45412
2020-05-21,DE,8386,39156,417,47542
2020-05-22,DE,8529,40457,420,48986
2020-05-23,DE,8690,41844,425,50534
2020-05-24,DE,8809,43061,431,51870
2020-05-25,DE,8965,44931,436,53896
2020-05-26,DE,9066,45848,444,54914
2020-05-27,DE,9096,46325,453,55421
2020-05-28,DE,9171,47630,459,56801
2020-05-29,DE,9236,48297,463,57533
2020-05-30,DE,9422,49907,466,59329
2020-05-31,DE,9498,51173,468,60671
2020-06-01,DE,9605,52842,471,62447
2020-06-02,DE,9685,54377,471,64062
2020-06-03,DE,9712,55208,475,64920
2020-06-04,DE,9746,56163,483,65909
2020-06-05,DE,9773,56956,485,66729
2020-06-06,DE,9845,57790,485,67635
2020-06-07,DE,9942,59055,488,68997
2020-06-08,DE,9972,59975,490,69947
2020-06-09,DE,10020,60733,492,70753
2020-06-10,DE,10056,61689,493,71745
2020-06-11,DE,10106,63927,494,74033
2020-06-12,DE,10173,67521,494,77694
2020-06-13,DE,10229,69870,495,80099
2020-06-14,DE,10264,71523,496,81787
2020-06-15,DE,10340,74346,498,84686
2020-06-16,DE,10403,75671,499,86074
2020-06-17,DE,10444,76143,502,86587
2020-06-18,DE,10499,78185,502,88684
2020-06-19,DE,10611,79823,504,90434
2020-06-20,DE,10681,81735,504,92416
2020-06-21,DE,10775,84199,504,94974
2020-06-22,DE,10820,85903,504,96723
2020-06-23,DE,10847,86689,504,97536
2020-06-24,DE,10889,87312,505,98201
2020-06-25,DE,10980,90012,507,100992
2020-06-26,DE,11017,91083,507,102100
2020-06-27,DE,11091,93171,507,104262
2020-06-28,DE,11226,95120,507,106346
2020-06-29,DE,11376,98555,507,109931
2020-06-30,DE,11474,99407,509,110881
2020-07-01,DE,11510,99874,509,111384
2020-07-02,DE,11731,103187,510,114918
2020-07-03,DE,11923,106420,512,118343
2020-07-04,DE,11996,108697,512,120693
2020-07-05,DE,12128,111813,512,123941
2020-07-06,DE,12293,114886,512,127179
2020-07-07,DE,12414,116271,514,128685
2020-07-08,DE,12462,116572,515,129034
2020-07-09,DE,12531,117674,517,130205
2020-07-10,DE,12652,120056,517,132708
2020-07-11,DE,12743,121372,517,134115
2020-07-12,DE,12804,124605,517,137409
2020-07-13,DE,12879,126484,517,139363
2020-07-14,DE,12969,128631,518,141600
2020-07-15,DE,13050,130338,521,143388
2020-07-16,DE,13114,131756,521,144870
2020-07-17,DE,13337,135273,521,148610
2020-07-18,DE,13429,137328,523,150757
2020-07-19,DE,13519,139476,523,152995
2020-07-20,DE,13519,139476,523,152995
2020-07-21,DE,13746,144601,525,158347
2020-07-22,DE,13792,145641,527,159433
2020-07-23,DE,13924,148427,529,162351
2020-03-04,FL,2,24,0,26
2020-03-05,FL,9,31,0,40
2020-03-06,FL,9,55,0,64
2020-03-07,FL,14,100,0,114
2020-03-08,FL,17,118,0,135
2020-03-09,FL,18,140,0,158
2020-03-10,FL,19,222,0,241
2020-03-11,FL,28,301,2,329
2020-03-12,FL,32,301,2,333
2020-03-13,FL,50,478,2,528
2020-03-14,FL,77,478,3,555
2020-03-15,FL,116,678,4,794
2020-03-16,FL,141,684,4,825
2020-03-17,FL,186,940,6,1126
2020-03-18,FL,314,1225,7,1539
2020-03-19,FL,390,1533,8,1923
2020-03-20,FL,520,1870,10,2390
2020-03-21,FL,658,6579,12,7237
2020-03-22,FL,830,7990,13,8820
2020-03-23,FL,1171,11063,14,12234
2020-03-24,FL,1412,13127,18,14539
2020-03-25,FL,1682,15374,22,17056
2020-03-26,FL,2355,23741,28,26096
2020-03-27,FL,2765,28186,34,30951
2020-03-28,FL,3763,35366,54,39129
2020-03-29,FL,4246,39070,56,43316
2020-03-30,FL,5473,48225,63,53698
2020-03-31,FL,6338,54285,77,60623
2020-04-01,FL,6955,59529,87,66484
2020-04-02,FL,8010,69286,128,77296
2020-04-03,FL,9585,82137,163,91722
2020-04-04,FL,11111,90956,191,102067
2020-04-05,FL,12151,101253,218,113404
2020-04-06,FL,13324,109950,236,123274
2020-04-07,FL,14747,123415,296,138162
2020-04-08,FL,15455,127679,309,143134
2020-04-09,FL,16364,136185,354,152549
2020-04-10,FL,17531,145299,390,162830
2020-04-11,FL,18494,154439,438,172933
2020-04-12,FL,19355,163398,465,182753
2020-04-13,FL,20601,175606,483,196207
2020-04-14,FL,21367,181813,537,203180
2020-04-15,FL,22511,190998,609,213509
2020-04-16,FL,22897,196351,646,219248
2020-04-17,FL,24119,210718,699,234837
2020-04-18,FL,25269,221258,754,246527
2020-04-19,FL,25996,230083,781,256079
2020-04-20,FL,26660,239565,806,266225
2020-04-21,FL,27495,249564,856,277059
2020-04-22,FL,28309,260318,910,288627
2020-04-23,FL,28832,267876,979,296708
2020-04-24,FL,30174,286785,1031,316959
2020-04-25,FL,30839,302260,1075,333099
2020-04-26,FL,31528,313085,1094,344613
2020-04-27,FL,32138,324325,1101,356463
2020-04-28,FL,32846,334029,1154,366875
2020-04-29,FL,33193,340295,1240,373488
2020-04-30,FL,33690,348715,1290,382405
2020-05-01,FL,34728,367971,1314,402699
2020-05-02,FL,35463,380549,1388,416012
2020-05-03,FL,36078,392111,1403,428189
2020-05-04,FL,36897,407373,1423,444270
2020-05-05,FL,37439,428252,1536,465691
2020-05-06,FL,38002,442049,1605,480051
2020-05-07,FL,38828,454122,1667,492950
2020-05-08,FL,39199,474142,1738,513341
2020-05-09,FL,40001,487730,1785,527731
2020-05-10,FL,40596,498352,1791,538948
2020-05-11,FL,40982,520075,1805,561057
2020-05-12,FL,41923,537681,1849,579604
2020-05-13,FL,42402,552361,1898,594763
2020-05-14,FL,43210,565627,1948,608837
2020-05-15,FL,43210,565627,1991,608837
2020-05-16,FL,44811,585236,2040,630047
2020-05-17,FL,45588,606204,2049,651792
2020-05-18,FL,46442,629970,2073,676412
2020-05-19,FL,46944,668911,2129,715855
2020-05-20,FL,47471,723877,2173,771348
2020-05-21,FL,48675,765254,2222,813929
2020-05-22,FL,49451,786045,2268,835496
2020-05-23,FL,50127,806310,2312,856437
2020-05-24,FL,50867,820368,2316,871235
2020-05-25,FL,51746,856489,2331,908235
2020-05-26,FL,52255,870969,2338,923224
2020-05-27,FL,52634,880937,2400,933571
2020-05-28,FL,53285,898331,2446,951616
2020-05-29,FL,54497,928742,2495,983239
2020-05-30,FL,55424,939544,2530,994968
2020-05-31,FL,56163,965186,2534,1021349
2020-06-01,FL,56830,983570,2543,1040400
2020-06-02,FL,57447,992305,2613,1049752
2020-06-03,FL,58764,1022149,2650,1080913
2020-06-04,FL,60183,1046860,2691,1107043
2020-06-05,FL,61488,1073452,2745,1134940
2020-06-06,FL,62758,1111427,2773,1174185
2020-06-07,FL,63938,1152220,2786,1216158
2020-06-08,FL,64904,1169646,2798,1234550
2020-06-09,FL,66000,1192305,2851,1258305
2020-06-10,FL,67371,1211652,2889,1279023
2020-06-11,FL,69069,1237679,2938,1306748
2020-06-12,FL,70971,1264928,2967,1335899
2020-06-13,FL,73552,1296861,3016,1370413
2020-06-14,FL,75568,1333447,3022,1409015
2020-06-15,FL,77326,1352858,3030,1430184
2020-06-16,FL,80109,1380200,3085,1460309
2020-06-17,FL,82719,1403040,3110,1485759
2020-06-18,FL,85926,1425386,3154,1511312
2020-06-19,FL,89748,1443123,3197,1532871
2020-06-20,FL,93797,1467475,3237,1561272
2020-06-21,FL,97291,1502005,3254,1599296
2020-06-22,FL,100217,1517270,3266,1617487
2020-06-23,FL,103503,1537249,3333,1640752
2020-06-24,FL,109014,1559328,3377,1668342
2020-06-25,FL,114018,1606626,3423,1720644
2020-06-26,FL,122960,1645925,3464,1768885
2020-06-27,FL,132545,1696980,3489,1829525
2020-06-28,FL,141075,1740822,3518,1881897
2020-06-29,FL,146341,1766402,3546,1912743
2020-06-30,FL,152434,1792561,3604,1944995
2020-07-01,FL,158997,1821357,3650,1980354
2020-07-02,FL,169106,1863077,3718,2032183
2020-07-03,FL,178594,1902766,3785,2081360
2020-07-04,FL,190052,1956445,3803,2146497
2020-07-05,FL,200111,2000088,3832,2200199
2020-07-06,FL,206447,2027493,3880,2233940
2020-07-07,FL,213794,2055400,3943,2269194
2020-07-08,FL,223783,2096424,3991,2320207
2020-07-09,FL,232718,2124680,4111,2357398
2020-07-10,FL,244151,2177476,4203,2421627
2020-07-11,FL,254511,2220788,4301,2475299
2020-07-12,FL,269811,2304196,4346,2574007
2020-07-13,FL,282435,2357139,4381,2639574
2020-07-14,FL,291629,2393614,4514,2685243
2020-07-15,FL,301810,2434143,4626,2735953
2020-07-16,FL,315775,2499843,4782,2815618
2020-07-17,FL,327241,2553527,4912,2880768
2020-07-18,FL,337569,2594419,5002,2931988
2020-07-19,FL,350047,2652594,5091,3002641
2020-07-20,FL,360394,2691712,5183,3052106
2020-07-21,FL,369834,2729916,5319,3099750
2020-07-22,FL,379619,2775092,5459,3154711
2020-07-23,FL,389868,2821074,5632,3210942
2020-03-04,GA,2,0,0,2
2020-03-05,GA,2,0,0,2
2020-03-06,GA,2,0,0,2
2020-03-07,GA,6,0,0,6
2020-03-08,GA,7,0,0,7
2020-03-09,GA,12,0,0,12
2020-03-10,GA,17,0,0,17
2020-03-11,GA,22,0,0,22
2020-03-12,GA,31,0,0,31
2020-03-13,GA,42,0,1,42
2020-03-14,GA,66,0,1,66
2020-03-15,GA,99,0,1,99
2020-03-16,GA,121,0,1,121
2020-03-17,GA,146,0,1,146
2020-03-18,GA,197,1311,1,1508
2020-03-19,GA,287,1544,10,1831
2020-03-20,GA,420,1966,13,2386
2020-03-21,GA,507,2557,14,3064
2020-03-22,GA,600,3420,23,4020
2020-03-23,GA,772,4297,25,5069
2020-03-24,GA,1026,4458,32,5484
2020-03-25,GA,1247,4932,40,6179
2020-03-26,GA,1525,7401,48,8926
2020-03-27,GA,2001,7864,64,9865
2020-03-28,GA,2366,8685,69,11051
2020-03-29,GA,2651,9913,80,12564
2020-03-30,GA,2809,9915,87,12724
2020-03-31,GA,3929,12252,111,16181
2020-04-01,GA,4638,15688,139,20326
2020-04-02,GA,5348,17609,163,22957
2020-04-03,GA,5831,19434,184,25265
2020-04-04,GA,6160,20134,201,26294
2020-04-05,GA,6647,21185,211,27832
2020-04-06,GA,7314,23960,229,31274
2020-04-07,GA,8818,24895,329,33713
2020-04-08,GA,9901,28886,362,38787
2020-04-09,GA,10566,30519,379,41085
2020-04-10,GA,11483,34664,416,46147
2020-04-11,GA,12159,39556,428,51715
2020-04-12,GA,12452,42001,433,54453
2020-04-13,GA,13315,43706,464,57021
2020-04-14,GA,14223,47572,501,61795
2020-04-15,GA,14987,49103,552,64090
2020-04-16,GA,15669,52270,587,67939
2020-04-17,GA,17194,54490,650,71684
2020-04-18,GA,17669,56539,673,74208
2020-04-19,GA,18301,61632,687,79933
2020-04-20,GA,18947,65381,733,84328
2020-04-21,GA,19881,68259,799,88140
2020-04-22,GA,20740,73332,836,94072
2020-04-23,GA,21512,79550,872,101062
2020-04-24,GA,22147,85029,892,107176
2020-04-25,GA,22695,96319,904,119014
2020-04-26,GA,23401,99822,912,123223
2020-04-27,GA,23913,103256,971,127169
2020-04-28,GA,24615,115405,1026,140020
2020-04-29,GA,25623,118155,1093,143778
2020-04-30,GA,26155,122889,1120,149044
2020-05-01,GA,27270,141097,1154,168367
2020-05-02,GA,28306,146494,1174,174800
2020-05-03,GA,28602,146494,1177,175096
2020-05-04,GA,29368,153957,1222,183325
2020-05-05,GA,29711,171172,1288,200883
2020-05-06,GA,30696,173441,1311,204137
2020-05-07,GA,31439,185864,1336,217303
2020-05-08,GA,32106,195461,1377,227567
2020-05-09,GA,32532,202792,1400,235324
2020-05-10,GA,33441,210106,1405,243547
2020-05-11,GA,33927,217361,1441,251288
2020-05-12,GA,34635,227544,1461,262179
2020-05-13,GA,35332,238572,1505,273904
2020-05-14,GA,35858,250023,1527,285881
2020-05-15,GA,36681,265193,1557,301874
2020-05-16,GA,37147,283922,1592,321069
2020-05-17,GA,37701,313474,1606,351175
2020-05-18,GA,38081,326208,1642,364289
2020-05-19,GA,38721,339435,1664,378156
2020-05-20,GA,39647,363293,1687,402940
2020-05-21,GA,40405,367326,1754,407731
2020-05-22,GA,41218,386031,1785,427249
2020-05-23,GA,42132,411405,1811,453537
2020-05-24,GA,42838,439116,1824,481954
2020-05-25,GA,43344,470201,1830,513545
2020-05-26,GA,43730,471215,1871,514945
2020-05-27,GA,44421,396335,1907,440756
2020-05-28,GA,45070,399576,1962,444646
2020-05-29,GA,45670,404601,1974,450271
2020-05-30,GA,46286,408552,2003,454838
2020-05-31,GA,46986,418539,2042,465525
2020-06-01,GA,47618,424013,2074,471631
2020-06-02,GA,48207,426080,2102,474287
2020-06-03,GA,48894,433818,2123,482712
2020-06-04,GA,49847,446484,2147,496331
2020-06-05,GA,50621,457167,2174,507788
2020-06-06,GA,51309,471548,2174,522857
2020-06-07,GA,51898,487986,2180,539884
2020-06-08,GA,52497,496878,2208,549375
2020-06-09,GA,53249,503934,2285,557183
2020-06-10,GA,53980,516975,2329,570955
2020-06-11,GA,54973,529268,2375,584241
2020-06-12,GA,55783,536175,2418,591958
2020-06-13,GA,56801,542879,2446,599680
2020-06-14,GA,57681,563109,2451,620790
2020-06-15,GA,58414,572082,2494,630496
2020-06-16,GA,59078,575900,2529,634978
2020-06-17,GA,60030,590437,2575,650467
2020-06-18,GA,60912,602292,2605,663204
2020-06-19,GA,62009,608297,2636,670306
2020-06-20,GA,63809,630575,2642,694384
2020-06-21,GA,64701,633606,2643,698307
2020-06-22,GA,65928,642098,2648,708026
2020-06-23,GA,67678,663583,2688,731261
2020-06-24,GA,69381,673853,2698,743234
2020-06-25,GA,71095,686829,2745,757924
2020-06-26,GA,72995,698033,2770,771028
2020-06-27,GA,74985,714828,2776,789813
2020-06-28,GA,77210,729728,2778,806938
2020-06-29,GA,79417,743700,2784,823117
2020-06-30,GA,81291,752587,2805,833878
2020-07-01,GA,84237,770801,2827,855038
2020-07-02,GA,87709,795530,2849,883239
2020-07-03,GA,90493,810724,2856,901217
2020-07-04,GA,93319,833040,2857,926359
2020-07-05,GA,95516,853669,2860,949185
2020-07-06,GA,97064,861889,2878,958953
2020-07-07,GA,100470,878982,2899,979452
2020-07-08,GA,103890,896519,2922,1000409
2020-07-09,GA,106727,912695,2930,1019422
2020-07-10,GA,111211,935137,2965,1046348
2020-07-11,GA,114401,950472,2996,1064873
2020-07-12,GA,116926,966490,3001,1083416
2020-07-13,GA,120569,987398,3026,1107967
2020-07-14,GA,123963,1007071,3054,1131034
2020-07-15,GA,127834,1027149,3091,1154983
2020-07-16,GA,131275,1046947,3104,1178222
2020-07-17,GA,135183,1063495,3132,1198678
2020-07-18,GA,139872,1091934,3168,1231806
2020-07-19,GA,143123,1112196,3173,1255319
2020-07-20,GA,145575,1128206,3176,1273781
2020-07-21,GA,148988,1146303,3254,1295291
2020-07-22,GA,152302,1164542,3335,1316844
2020-07-23,GA,156588,1180350,3360,1336938
2020-03-16,GU,3,23,0,26
2020-03-17,GU,5,41,0,46
2020-03-18,GU,8,57,0,65
2020-03-19,GU,12,69,0,81
2020-03-20,GU,14,86,0,100
2020-03-21,GU,15,108,0,123
2020-03-22,GU,27,126,1,153
2020-03-23,GU,29,161,1,190
2020-03-24,GU,32,201,1,233
2020-03-25,GU,37,233,1,270
2020-03-26,GU,45,263,1,308
2020-03-27,GU,51,299,1,350
2020-03-28,GU,55,299,1,354
2020-03-29,GU,56,334,1,390
2020-03-30,GU,58,352,1,410
2020-03-31,GU,69,371,2,440
2020-04-01,GU,77,406,3,483
2020-04-02,GU,82,442,3,524
2020-04-03,GU,84,459,4,543
2020-04-04,GU,93,472,4,565
2020-04-05,GU,112,493,4,605
2020-04-06,GU,113,505,4,618
2020-04-07,GU,121,529,4,650
2020-04-08,GU,125,562,4,687
2020-04-09,GU,128,593,4,721
2020-04-10,GU,130,662,4,792
2020-04-11,GU,133,693,5,826
2020-04-12,GU,133,693,5,826
2020-04-13,GU,133,770,5,903
2020-04-14,GU,133,811,5,944
2020-04-15,GU,133,843,5,976
2020-04-16,GU,133,870,5,1003
2020-04-17,GU,133,940,5,1073
2020-04-18,GU,133,943,5,1076
2020-04-19,GU,133,943,5,1076
2020-04-20,GU,133,991,5,1124
2020-04-21,GU,133,1033,5,1166
2020-04-22,GU,134,1086,5,1220
2020-04-23,GU,135,1180,5,1315
2020-04-24,GU,141,1233,5,1374
2020-04-25,GU,141,1308,5,1449
2020-04-26,GU,141,1387,5,1528
2020-04-27,GU,144,1424,5,1568
2020-04-28,GU,145,1538,5,1683
2020-04-29,GU,145,1702,5,1847
2020-04-30,GU,146,1962,5,2108
2020-05-01,GU,146,2859,5,3005
2020-05-02,GU,148,3040,5,3188
2020-05-03,GU,150,3152,5,3302
2020-05-04,GU,149,3242,5,3391
2020-05-05,GU,149,3341,5,3490
2020-05-06,GU,151,3476,5,3627
2020-05-07,GU,151,3564,5,3715
2020-05-08,GU,151,3626,5,3777
2020-05-09,GU,151,3643,5,3794
2020-05-10,GU,151,3643,5,3794
2020-05-11,GU,151,3838,5,3989
2020-05-12,GU,152,3939,5,4091
2020-05-13,GU,152,4110,5,4262
2020-05-14,GU,153,4226,5,4379
2020-05-15,GU,154,4361,5,4515
2020-05-16,GU,154,4365,5,4519
2020-05-17,GU,154,4450,5,4604
2020-05-18,GU,154,4569,5,4723
2020-05-19,GU,154,4673,5,4827
2020-05-20,GU,165,4807,5,4972
2020-05-21,GU,165,4899,5,5064
2020-05-22,GU,165,5114,5,5279
2020-05-23,GU,165,5194,5,5359
2020-05-24,GU,166,5403,5,5569
2020-05-25,GU,166,5403,5,5569
2020-05-26,GU,169,5515,5,5684
2020-05-27,GU,170,5515,5,5685
2020-05-28,GU,172,5790,5,5962
2020-05-29,GU,172,5923,5,6095
2020-05-30,GU,173,5929,5,6102
2020-05-31,GU,173,5929,5,6102
2020-06-01,GU,175,6141,5,6316
2020-06-02,GU,177,6214,5,6391
2020-06-03,GU,178,6549,5,6727
2020-06-04,GU,179,6805,5,6984
2020-06-05,GU,179,7195,5,7374
2020-06-06,GU,179,7284,5,7463
2020-06-07,GU,179,7284,5,7463
2020-06-08,GU,179,7550,5,7729
2020-06-09,GU,180,7796,5,7976
2020-06-10,GU,182,8100,5,8282
2020-06-11,GU,183,8197,5,8380
2020-06-12,GU,184,8343,5,8527
2020-06-13,GU,185,8358,5,8543
2020-06-14,GU,185,8358,5,8543
2020-06-15,GU,185,8573,5,8758
2020-06-16,GU,186,8846,5,9032
2020-06-17,GU,188,9010,5,9198
2020-06-18,GU,193,9395,5,9588
2020-06-19,GU,200,9515,5,9715
2020-06-20,GU,222,9788,5,10010
2020-06-21,GU,222,9788,5,10010
2020-06-22,GU,224,10180,5,10404
2020-06-23,GU,225,10426,5,10651
2020-06-24,GU,231,10807,5,11038
2020-06-25,GU,245,11173,5,11418
2020-06-26,GU,248,11644,5,11892
2020-06-27,GU,248,11903,5,12151
2020-06-28,GU,248,12130,5,12378
2020-06-29,GU,255,12659,5,12914
2020-06-30,GU,259,13056,5,13315
2020-07-01,GU,267,13517,5,13784
2020-07-02,GU,280,13653,5,13933
2020-07-03,GU,286,14263,5,14549
2020-07-04,GU,288,14666,5,14954
2020-07-05,GU,288,14666,5,14954
2020-07-06,GU,301,15248,5,15549
2020-07-07,GU,303,15608,5,15911
2020-07-08,GU,307,15833,5,16140
2020-07-09,GU,309,16223,5,16532
2020-07-10,GU,310,16556,5,16866
2020-07-11,GU,312,16667,5,16979
2020-07-12,GU,312,16667,5,16979
2020-07-13,GU,312,17030,5,17342
2020-07-14,GU,312,17225,5,17537
2020-07-15,GU,313,17514,5,17827
2020-07-16,GU,314,17697,5,18011
2020-07-17,GU,314,17938,5,18252
2020-07-18,GU,315,17938,5,18253
2020-07-19,GU,315,17938,5,18253
2020-07-20,GU,319,18252,5,18571
2020-07-21,GU,327,18430,5,18757
2020-07-22,GU,330,18752,5,19082
2020-07-23,GU,332,19132,5,19464
2020-03-07,HI,1,0,0,1
2020-03-08,HI,1,0,0,1
2020-03-09,HI,2,0,0,2
2020-03-10,HI,2,0,0,2
2020-03-11,HI,2,0,0,2
2020-03-12,HI,2,0,0,2
2020-03-13,HI,2,0,0,2
2020-03-14,HI,2,0,0,2
2020-03-15,HI,2,0,0,2
2020-03-16,HI,7,0,0,7
2020-03-17,HI,10,0,0,10
2020-03-18,HI,14,93,0,107
2020-03-19,HI,16,93,0,109
2020-03-20,HI,26,124,0,150
2020-03-21,HI,37,124,0,161
2020-03-22,HI,48,263,0,311
2020-03-23,HI,56,2955,0,3011
2020-03-24,HI,77,3589,0,3666
2020-03-25,HI,90,4357,0,4447
2020-03-26,HI,95,4357,0,4452
2020-03-27,HI,106,4357,0,4463
2020-03-28,HI,120,4357,0,4477
2020-03-29,HI,151,6849,0,7000
2020-03-30,HI,175,7825,0,8000
2020-03-31,HI,204,8471,0,8675
2020-04-01,HI,208,8721,1,8929
2020-04-02,HI,258,10206,1,10464
2020-04-03,HI,285,10206,2,10491
2020-04-04,HI,319,11959,3,12278
2020-04-05,HI,351,12604,4,12955
2020-04-06,HI,371,13155,4,13526
2020-04-07,HI,387,13155,5,13542
2020-04-08,HI,410,14739,5,15149
2020-04-09,HI,435,15316,5,15751
2020-04-10,HI,442,15707,6,16149
2020-04-11,HI,465,17066,8,17531
2020-04-12,HI,486,17482,8,17968
2020-04-13,HI,499,18345,9,18844
2020-04-14,HI,504,18916,9,19420
2020-04-15,HI,517,19286,9,19803
2020-04-16,HI,530,20170,9,20700
2020-04-17,HI,541,21316,9,21857
2020-04-18,HI,553,21790,9,22343
2020-04-19,HI,574,22896,9,23470
2020-04-20,HI,580,23595,10,24175
2020-04-21,HI,584,24112,10,24696
2020-04-22,HI,586,24760,12,25346
2020-04-23,HI,592,25536,12,26128
2020-04-24,HI,596,26291,12,26887
2020-04-25,HI,601,27439,13,28040
2020-04-26,HI,603,27880,14,28483
2020-04-27,HI,606,28404,14,29010
2020-04-28,HI,607,28576,16,29183
2020-04-29,HI,609,29009,16,29618
2020-04-30,HI,613,30027,16,30640
2020-05-01,HI,618,30476,16,31094
2020-05-02,HI,619,31366,16,31985
2020-05-03,HI,620,32330,16,32950
2020-05-04,HI,620,33246,17,33866
2020-05-05,HI,621,33378,17,33999
2020-05-06,HI,625,34574,17,35199
2020-05-07,HI,626,34915,17,35541
2020-05-08,HI,629,35989,17,36618
2020-05-09,HI,629,35633,17,36262
2020-05-10,HI,631,36639,17,37270
2020-05-11,HI,632,37051,17,37683
2020-05-12,HI,634,37305,17,37939
2020-05-13,HI,635,37730,17,38365
2020-05-14,HI,638,38243,17,38881
2020-05-15,HI,637,38139,17,38776
2020-05-16,HI,638,40245,17,40883
2020-05-17,HI,639,41035,17,41674
2020-05-18,HI,640,41405,17,42045
2020-05-19,HI,640,44383,17,45023
2020-05-20,HI,641,45663,17,46304
2020-05-21,HI,643,46506,17,47149
2020-05-22,HI,647,47338,17,47985
2020-05-23,HI,642,48179,17,48821
2020-05-24,HI,643,48929,17,49572
2020-05-25,HI,643,49728,17,50371
2020-05-26,HI,643,49728,17,50371
2020-05-27,HI,643,50559,17,51202
2020-05-28,HI,644,51195,17,51839
2020-05-29,HI,647,52177,17,52824
2020-05-30,HI,649,53365,17,54014
2020-05-31,HI,651,53969,17,54620
2020-06-01,HI,652,47835,17,48487
2020-06-02,HI,652,48269,17,48921
2020-06-03,HI,653,48855,17,49508
2020-06-04,HI,653,49985,17,50638
2020-06-05,HI,655,51681,17,52336
2020-06-06,HI,664,52593,17,53257
2020-06-07,HI,673,53382,17,54055
2020-06-08,HI,675,54472,17,55147
2020-06-09,HI,676,54798,17,55474
2020-06-10,HI,682,55491,17,56173
2020-06-11,HI,685,56610,17,57295
2020-06-12,HI,692,57887,17,58579
2020-06-13,HI,706,58632,17,59338
2020-06-14,HI,723,59599,17,60322
2020-06-15,HI,728,60746,17,61474
2020-06-16,HI,736,61292,17,62028
2020-06-17,HI,740,62503,17,63243
2020-06-18,HI,744,63630,17,64374
2020-06-19,HI,762,64982,17,65744
2020-06-20,HI,789,65945,17,66734
2020-06-21,HI,803,67057,17,67860
2020-06-22,HI,814,67897,17,68711
2020-06-23,HI,816,68524,17,69340
2020-06-24,HI,819,69720,17,70539
2020-06-25,HI,835,71100,17,71935
2020-06-26,HI,850,72155,17,73005
2020-06-27,HI,866,73435,17,74301
2020-06-28,HI,872,74606,18,75478
2020-06-29,HI,899,76256,18,77155
2020-06-30,HI,900,76843,18,77743
2020-07-01,HI,917,78141,18,79058
2020-07-02,HI,926,79364,18,80290
2020-07-03,HI,946,80672,18,81618
2020-07-04,HI,975,82501,19,83476
2020-07-05,HI,999,83326,19,84325
2020-07-06,HI,1023,84035,19,85058
2020-07-07,HI,1030,84643,19,85673
2020-07-08,HI,1071,86025,19,87096
2020-07-09,HI,1094,88058,19,89152
2020-07-10,HI,1130,89465,19,90595
2020-07-11,HI,1158,91076,19,92234
2020-07-12,HI,1200,92720,19,93920
2020-07-13,HI,1220,93950,19,95170
2020-07-14,HI,1243,94827,22,96070
2020-07-15,HI,1264,96293,22,97557
2020-07-16,HI,1292,98095,22,99387
2020-07-17,HI,1311,99893,22,101204
2020-07-18,HI,1334,101661,23,102995
2020-07-19,HI,1354,103281,24,104635
2020-07-20,HI,1381,104575,24,105956
2020-07-21,HI,1393,105390,24,106783
2020-07-22,HI,1418,106764,24,108182
2020-07-23,HI,1435,107378,25,108813
2020-03-06,IA,0,15,0,15
2020-03-07,IA,0,15,0,15
2020-03-08,IA,0,15,0,15
2020-03-09,IA,3,26,0,29
2020-03-10,IA,8,32,0,40
2020-03-11,IA,13,46,0,59
2020-03-12,IA,14,67,0,81
2020-03-13,IA,16,83,0,99
2020-03-14,IA,17,83,0,100
2020-03-15,IA,18,83,0,101
2020-03-16,IA,22,83,0,105
2020-03-17,IA,23,83,0,106
2020-03-18,IA,29,83,0,112
2020-03-19,IA,38,83,0,121
2020-03-20,IA,45,642,0,687
2020-03-21,IA,68,1049,0,1117
2020-03-22,IA,90,1215,0,1305
2020-03-23,IA,105,2043,0,2148
2020-03-24,IA,124,2315,0,2439
2020-03-25,IA,145,2578,1,2723
2020-03-26,IA,179,2578,1,2757
2020-03-27,IA,235,3740,3,3975
2020-03-28,IA,298,4375,3,4673
2020-03-29,IA,336,5013,4,5349
2020-03-30,IA,424,6162,6,6586
2020-03-31,IA,497,6888,7,7385
2020-04-01,IA,549,7304,9,7853
2020-04-02,IA,614,8054,11,8668
2020-04-03,IA,699,8754,11,9453
2020-04-04,IA,786,9454,14,10240
2020-04-05,IA,868,9973,22,10841
2020-04-06,IA,946,10653,25,11599
2020-04-07,IA,1048,11670,26,12718
2020-04-08,IA,1145,12821,27,13966
2020-04-09,IA,1270,13703,29,14973
2020-04-10,IA,1388,14565,31,15953
2020-04-11,IA,1510,15622,34,17132
2020-04-12,IA,1587,16005,41,17592
2020-04-13,IA,1710,16986,43,18696
2020-04-14,IA,1899,16986,49,18885
2020-04-15,IA,1995,17874,53,19869
2020-04-16,IA,2141,18534,60,20675
2020-04-17,IA,2332,19460,64,21792
2020-04-18,IA,2513,20434,74,22947
2020-04-19,IA,2902,21648,75,24550
2020-04-20,IA,3159,22661,79,25820
2020-04-21,IA,3641,23974,83,27615
2020-04-22,IA,3748,24496,90,28244
2020-04-23,IA,3924,25338,96,29262
2020-04-24,IA,4445,27528,107,31973
2020-04-25,IA,5092,29258,112,34350
2020-04-26,IA,5476,30614,118,36090
2020-04-27,IA,5868,32282,127,38150
2020-04-28,IA,6376,33447,136,39823
2020-04-29,IA,6843,34494,148,41337
2020-04-30,IA,7145,35522,162,42667
2020-05-01,IA,7884,37708,170,45592
2020-05-02,IA,8641,37708,175,46349
2020-05-03,IA,9169,44017,184,53186
2020-05-04,IA,9703,47458,188,57161
2020-05-05,IA,10111,50458,207,60569
2020-05-06,IA,10404,52767,219,63171
2020-05-07,IA,11059,55368,231,66427
2020-05-08,IA,11457,58804,243,70261
2020-05-09,IA,11671,59805,252,71476
2020-05-10,IA,11959,62215,265,74174
2020-05-11,IA,12373,65419,271,77792
2020-05-12,IA,12912,68376,289,81288
2020-05-13,IA,13289,72430,306,85719
2020-05-14,IA,13675,75619,318,89294
2020-05-15,IA,14049,79517,336,93566
2020-05-16,IA,14328,81972,346,96300
2020-05-17,IA,14651,85590,351,100241
2020-05-18,IA,14955,88193,355,103148
2020-05-19,IA,15349,92299,372,107648
2020-05-20,IA,15614,95134,388,110748
2020-05-21,IA,16170,100395,406,116565
2020-05-22,IA,16504,103746,425,120250
2020-05-23,IA,16893,107048,444,123941
2020-05-24,IA,17252,110504,454,127756
2020-05-25,IA,17577,115138,459,132715
2020-05-26,IA,17703,117301,478,135004
2020-05-27,IA,18360,121166,491,139526
2020-05-28,IA,18573,124360,504,142933
2020-05-29,IA,18926,128394,522,147320
2020-05-30,IA,19244,131179,531,150423
2020-05-31,IA,19552,136744,534,156296
2020-06-01,IA,19697,139384,551,159081
2020-06-02,IA,20016,143674,561,163690
2020-06-03,IA,20055,144390,574,164445
2020-06-04,IA,20805,154130,580,174935
2020-06-05,IA,21152,159511,592,180663
2020-06-06,IA,21478,163236,598,184714
2020-06-07,IA,21667,166525,604,188192
2020-06-08,IA,21987,171635,612,193622
2020-06-09,IA,22236,175487,624,197723
2020-06-10,IA,22551,180278,630,202829
2020-06-11,IA,22938,185601,639,208539
2020-06-12,IA,23337,191207,643,214544
2020-06-13,IA,23717,195891,650,219608
2020-06-14,IA,23926,200708,652,224634
2020-06-15,IA,24053,203335,655,227388
2020-06-16,IA,24179,206459,669,230638
2020-06-17,IA,24461,210670,673,235131
2020-06-18,IA,24854,216077,679,240931
2020-06-19,IA,25275,221374,681,246649
2020-06-20,IA,25496,224711,681,250207
2020-06-21,IA,25963,231189,685,257152
2020-06-22,IA,26051,232581,686,258632
2020-06-23,IA,26373,238330,688,264703
2020-06-24,IA,26705,243254,692,269959
2020-06-25,IA,27197,249857,695,277054
2020-06-26,IA,27686,255957,704,283643
2020-06-27,IA,28012,261740,704,289752
2020-06-28,IA,28489,267426,705,295915
2020-06-29,IA,28782,272063,708,300845
2020-06-30,IA,29007,275181,715,304188
2020-07-01,IA,29451,280339,717,309790
2020-07-02,IA,30209,287329,718,317538
2020-07-03,IA,30429,291032,720,321461
2020-07-04,IA,31041,297970,721,329011
2020-07-05,IA,31353,301119,721,332472
2020-07-06,IA,31657,303805,723,335462
2020-07-07,IA,32029,307269,725,339298
2020-07-08,IA,32509,313842,735,346351
2020-07-09,IA,33240,321419,739,354659
2020-07-10,IA,33984,328264,743,362248
2020-07-11,IA,34647,333714,748,368361
2020-07-12,IA,35071,339342,750,374413
2020-07-13,IA,35529,341187,754,376716
2020-07-14,IA,35849,344559,757,380408
2020-07-15,IA,36291,351021,762,387312
2020-07-16,IA,37132,359319,778,396451
2020-07-17,IA,37722,364731,784,402453
2020-07-18,IA,37907,365822,787,403729
2020-07-19,IA,38723,376768,794,415491
2020-07-20,IA,39166,379378,797,418544
2020-07-21,IA,39474,382959,802,422433
2020-07-22,IA,39793,386643,808,426436
2020-07-23,IA,40634,395652,818,436286
2020-03-07,ID,0,27,0,27
2020-03-08,ID,0,27,0,27
2020-03-09,ID,0,41,0,41
2020-03-10,ID,0,41,0,41
2020-03-11,ID,0,67,0,67
2020-03-12,ID,0,93,0,93
2020-03-13,ID,0,131,0,131
2020-03-14,ID,2,174,0,176
2020-03-15,ID,5,174,0,179
2020-03-16,ID,5,265,0,270
2020-03-17,ID,7,346,0,353
2020-03-18,ID,9,459,0,468
2020-03-19,ID,11,459,0,470
2020-03-20,ID,23,590,0,613
2020-03-21,ID,31,880,0,911
2020-03-22,ID,42,1175,0,1217
2020-03-23,ID,47,1309,0,1356
2020-03-24,ID,50,1887,0,1937
2020-03-25,ID,73,1887,0,1960
2020-03-26,ID,123,2065,0,2188
2020-03-27,ID,189,2668,3,2857
2020-03-28,ID,230,3342,4,3572
2020-03-29,ID,261,4021,5,4282
2020-03-30,ID,310,4396,6,4706
2020-03-31,ID,415,5297,7,5712
2020-04-01,ID,525,6076,9,6601
2020-04-02,ID,669,6613,9,7282
2020-04-03,ID,891,7054,9,7945
2020-04-04,ID,1013,7857,10,8870
2020-04-05,ID,1077,9184,10,10261
2020-04-06,ID,1101,9894,10,10995
2020-04-07,ID,1170,10076,13,11246
2020-04-08,ID,1210,10688,15,11898
2020-04-09,ID,1232,11299,18,12531
2020-04-10,ID,1353,11741,24,13094
2020-04-11,ID,1396,12368,25,13764
2020-04-12,ID,1407,12901,27,14308
2020-04-13,ID,1426,13455,27,14881
2020-04-14,ID,1453,13661,33,15114
2020-04-15,ID,1464,13934,39,15398
2020-04-16,ID,1587,14655,41,16242
2020-04-17,ID,1609,15043,41,16652
2020-04-18,ID,1655,15292,43,16947
2020-04-19,ID,1668,15773,44,17441
2020-04-20,ID,1672,15773,45,17445
2020-04-21,ID,1736,16071,48,17807
2020-04-22,ID,1766,16404,51,18170
2020-04-23,ID,1802,17370,54,19172
2020-04-24,ID,1836,17611,54,19447
2020-04-25,ID,1870,17611,54,19481
2020-04-26,ID,1887,17611,56,19498
2020-04-27,ID,1897,18127,56,20024
2020-04-28,ID,1917,18135,58,20052
2020-04-29,ID,1952,26430,60,28382
2020-04-30,ID,1984,26862,60,28846
2020-05-01,ID,2015,27210,63,29225
2020-05-02,ID,2035,27455,63,29490
2020-05-03,ID,2061,27746,63,29807
2020-05-04,ID,2061,27746,64,29807
2020-05-05,ID,2106,28202,64,30308
2020-05-06,ID,2127,28418,65,30545
2020-05-07,ID,2158,28732,66,30890
2020-05-08,ID,2178,29092,67,31270
2020-05-09,ID,2205,29601,67,31806
2020-05-10,ID,2230,29912,67,32142
2020-05-11,ID,2230,29912,67,32142
2020-05-12,ID,2260,30445,70,32705
2020-05-13,ID,2293,30835,69,33128
2020-05-14,ID,2324,31430,69,33754
2020-05-15,ID,2351,32394,72,34745
2020-05-16,ID,2389,33299,73,35688
2020-05-17,ID,2419,34253,73,36672
2020-05-18,ID,2419,34253,73,36672
2020-05-19,ID,2455,35614,74,38069
2020-05-20,ID,2476,36091,77,38567
2020-05-21,ID,2506,36382,77,38888
2020-05-22,ID,2534,37061,77,39595
2020-05-23,ID,2595,38014,79,40609
2020-05-24,ID,2626,38780,79,41406
2020-05-25,ID,2626,38780,79,41406
2020-05-26,ID,2626,38780,79,41406
2020-05-27,ID,2699,40318,81,43017
2020-05-28,ID,2731,41144,82,43875
2020-05-29,ID,2769,41992,82,44761
2020-05-30,ID,2803,42621,82,45424
2020-05-31,ID,2839,43858,82,46697
2020-06-01,ID,2839,43858,82,46697
2020-06-02,ID,2906,45227,83,48133
2020-06-03,ID,2933,46009,83,48942
2020-06-04,ID,2990,46815,83,49805
2020-06-05,ID,3054,50570,83,53624
2020-06-06,ID,3111,52128,83,55239
2020-06-07,ID,3139,52902,83,56041
2020-06-08,ID,3139,52902,83,56041
2020-06-09,ID,3189,54488,83,57677
2020-06-10,ID,3220,55832,85,59052
2020-06-11,ID,3260,56855,85,60115
2020-06-12,ID,3302,58130,86,61432
2020-06-13,ID,3353,59305,87,62658
2020-06-14,ID,3399,59581,87,62980
2020-06-15,ID,3399,59581,87,62980
2020-06-16,ID,3462,62185,88,65647
2020-06-17,ID,3540,63244,88,66784
2020-06-18,ID,3632,64380,88,68012
2020-06-19,ID,3743,65802,89,69545
2020-06-20,ID,3871,67325,89,71196
2020-06-21,ID,4006,68962,89,72968
2020-06-22,ID,4006,68962,89,72968
2020-06-23,ID,4254,71910,89,76164
2020-06-24,ID,4402,73433,89,77835
2020-06-25,ID,4645,75894,90,80539
2020-06-26,ID,4865,77505,90,82370
2020-06-27,ID,5148,78908,90,84056
2020-06-28,ID,5319,81026,91,86345
2020-06-29,ID,5319,81026,91,86345
2020-06-30,ID,5752,83551,91,89303
2020-07-01,ID,6117,84923,92,91040
2020-07-02,ID,6370,88751,92,95121
2020-07-03,ID,6593,92116,92,98709
2020-07-04,ID,6994,94073,93,101067
2020-07-05,ID,7370,96896,93,104266
2020-07-06,ID,7733,98732,93,106465
2020-07-07,ID,8052,100489,94,108541
2020-07-08,ID,8539,102792,94,111331
2020-07-09,ID,8969,105651,98,114620
2020-07-10,ID,9428,108650,100,118078
2020-07-11,ID,9928,112421,101,122349
2020-07-12,ID,10505,114756,102,125261
2020-07-13,ID,10902,116230,102,127132
2020-07-14,ID,11402,118882,102,130284
2020-07-15,ID,11718,122196,103,133914
2020-07-16,ID,12445,124418,110,136863
2020-07-17,ID,13133,127186,114,140319
2020-07-18,ID,13752,128753,118,142505
2020-07-19,ID,14302,131884,119,146186
2020-07-20,ID,14873,133015,119,147888
2020-07-21,ID,15266,135805,122,151071
2020-07-22,ID,15822,138149,126,153971
2020-07-23,ID,16322,140504,135,156826
2020-03-04,IL,4,124,0,128
2020-03-05,IL,5,165,0,170
2020-03-06,IL,5,180,0,185
2020-03-07,IL,6,191,0,197
2020-03-08,IL,6,191,0,197
2020-03-09,IL,7,191,0,198
2020-03-10,IL,19,244,0,263
2020-03-11,IL,19,244,0,263
2020-03-12,IL,25,266,0,291
2020-03-13,IL,32,294,0,326
2020-03-14,IL,46,316,0,362
2020-03-15,IL,64,449,0,513
2020-03-16,IL,93,932,0,1025
2020-03-17,IL,159,1340,1,1499
2020-03-18,IL,288,1763,1,2051
2020-03-19,IL,422,2725,4,3147
2020-03-20,IL,585,3696,5,4281
2020-03-21,IL,753,5488,6,6241
2020-03-22,IL,1049,7271,9,8320
2020-03-23,IL,1273,8583,12,9856
2020-03-24,IL,1535,9934,16,11469
2020-03-25,IL,1865,12344,19,14209
2020-03-26,IL,2538,14093,26,16631
2020-03-27,IL,3026,18516,34,21542
2020-03-28,IL,3491,22000,47,25491
2020-03-29,IL,4596,23166,65,27762
2020-03-30,IL,5057,25389,73,30446
2020-03-31,IL,5994,29231,99,35225
2020-04-01,IL,6980,33404,141,40384
2020-04-02,IL,7695,35961,157,43656
2020-04-03,IL,8904,39144,210,48048
2020-04-04,IL,10357,43224,243,53581
2020-04-05,IL,11256,47727,274,58983
2020-04-06,IL,12262,50680,307,62942
2020-04-07,IL,13549,55183,380,68732
2020-04-08,IL,15078,59988,462,75066
2020-04-09,IL,16422,64435,528,80857
2020-04-10,IL,17887,69640,596,87527
2020-04-11,IL,19180,72969,677,92149
2020-04-12,IL,20852,79883,720,100735
2020-04-13,IL,22025,83743,794,105768
2020-04-14,IL,23247,87369,868,110616
2020-04-15,IL,24593,92336,948,116929
2020-04-16,IL,25733,96856,1072,122589
2020-04-17,IL,27575,102588,1134,130163
2020-04-18,IL,29160,108244,1259,137404
2020-04-19,IL,30357,112961,1290,143318
2020-04-20,IL,31508,116850,1349,148358
2020-04-21,IL,33059,121938,1468,154997
2020-04-22,IL,35108,129238,1565,164346
2020-04-23,IL,36934,136382,1688,173316
2020-04-24,IL,39658,149974,1795,189632
2020-04-25,IL,41777,159840,1874,201617
2020-04-26,IL,43903,171049,1933,214952
2020-04-27,IL,45883,181745,1983,227628
2020-04-28,IL,48102,194087,2125,242189
2020-04-29,IL,50355,206312,2215,256667
2020-04-30,IL,52918,216949,2355,269867
2020-05-01,IL,56055,228633,2457,284688
2020-05-02,IL,58505,241391,2559,299896
2020-05-03,IL,61499,257814,2618,319313
2020-05-04,IL,63840,269307,2662,333147
2020-05-05,IL,65962,280324,2838,346286
2020-05-06,IL,68232,293028,2974,361260
2020-05-07,IL,70873,308170,3111,379043
2020-05-08,IL,73760,325954,3241,399714
2020-05-09,IL,76085,340246,3349,416331
2020-05-10,IL,77741,352243,3406,429984
2020-05-11,IL,79007,363418,3459,442425
2020-05-12,IL,83021,388670,3601,471691
2020-05-13,IL,84698,404661,3792,489359
2020-05-14,IL,87937,424100,3928,512037
2020-05-15,IL,90369,448233,4058,538602
2020-05-16,IL,92457,469192,4129,561649
2020-05-17,IL,94191,487753,4177,581944
2020-05-18,IL,96485,506756,4234,603241
2020-05-19,IL,98030,523654,4379,621684
2020-05-20,IL,100418,542295,4525,642713
2020-05-21,IL,102686,569334,4607,672020
2020-05-22,IL,105444,591689,4715,697133
2020-05-23,IL,107796,614451,4790,722247
2020-05-24,IL,110304,637617,4856,747921
2020-05-25,IL,112017,657547,4884,769564
2020-05-26,IL,113195,673599,4923,786794
2020-05-27,IL,114306,689667,5083,803973
2020-05-28,IL,115833,714133,5186,829966
2020-05-29,IL,117455,734307,5270,851762
2020-05-30,IL,118917,758188,5330,877105
2020-05-31,IL,120260,777999,5390,898259
2020-06-01,IL,121234,797039,5412,918273
2020-06-02,IL,122848,811856,5525,934704
2020-06-03,IL,123830,835345,5621,959175
2020-06-04,IL,124759,857257,5736,982016
2020-06-05,IL,125915,875004,5795,1000919
2020-06-06,IL,126890,895184,5864,1022074
2020-06-07,IL,127757,915017,5904,1042774
2020-06-08,IL,129139,930458,6102,1059597
2020-06-09,IL,129936,949970,6196,1079906
2020-06-10,IL,130561,970165,6273,1100726
2020-06-11,IL,131327,991724,6363,1123051
2020-06-12,IL,132059,1015903,6441,1147962
2020-06-13,IL,132732,1037074,6470,1169806
2020-06-14,IL,133404,1058442,6489,1191846
2020-06-15,IL,133877,1076596,6507,1210473
2020-06-16,IL,134500,1094702,6579,1229202
2020-06-17,IL,135046,1124143,6666,1259189
2020-06-18,IL,135639,1149054,6718,1284693
2020-06-19,IL,136470,1175533,6718,1312003
2020-06-20,IL,137104,1200864,6829,1337968
2020-06-21,IL,137762,1224022,6851,1361784
2020-06-22,IL,138224,1241779,6875,1380003
2020-06-23,IL,138825,1261685,6911,1400510
2020-06-24,IL,139540,1290301,6974,1429841
2020-06-25,IL,140434,1321093,7014,1461527
2020-06-26,IL,141344,1350661,7048,1492005
2020-06-27,IL,142130,1380112,7074,1522242
2020-06-28,IL,142776,1403255,7089,1546031
2020-06-29,IL,143514,1429435,7103,1572949
2020-06-30,IL,144238,1459780,7124,1604018
2020-07-01,IL,145066,1492042,7152,1637108
2020-07-02,IL,145935,1521435,7188,1667370
2020-07-03,IL,146872,1554885,7215,1701757
2020-07-04,IL,147734,1587859,7224,1735593
2020-07-05,IL,148373,1614455,7230,1762828
2020-07-06,IL,148987,1634975,7236,1783962
2020-07-07,IL,149574,1661382,7273,1810956
2020-07-08,IL,150554,1693144,7309,1843698
2020-07-09,IL,151572,1728306,7329,1879878
2020-07-10,IL,152899,1759976,7345,1912875
2020-07-11,IL,154094,1791126,7369,1945220
2020-07-12,IL,155048,1829066,7388,1984114
2020-07-13,IL,155931,1858195,7394,2014126
2020-07-14,IL,156638,1885934,7419,2042572
2020-07-15,IL,157825,1922908,7427,2080733
2020-07-16,IL,159082,1964657,7452,2123739
2020-07-17,IL,160509,2006965,7465,2167474
2020-07-18,IL,161785,2051788,7483,2213573
2020-07-19,IL,162750,2082936,7488,2245686
2020-07-20,IL,163923,2116361,7494,2280284
2020-07-21,IL,164878,2145151,7517,2310029
2020-07-22,IL,166476,2183186,7540,2349662
2020-07-23,IL,168100,2221268,7560,2389368
2020-03-06,IN,1,0,0,1
2020-03-07,IN,1,0,0,1
2020-03-08,IN,2,0,0,2
2020-03-09,IN,2,0,0,2
2020-03-10,IN,6,30,0,36
2020-03-11,IN,10,33,0,43
2020-03-12,IN,12,52,0,64
2020-03-13,IN,12,61,0,73
2020-03-14,IN,15,74,0,89
2020-03-15,IN,19,102,0,121
2020-03-16,IN,24,115,1,139
2020-03-17,IN,30,129,2,159
2020-03-18,IN,39,154,2,193
2020-03-19,IN,56,324,2,380
2020-03-20,IN,79,475,2,554
2020-03-21,IN,126,707,4,833
2020-03-22,IN,201,1293,6,1494
2020-03-23,IN,259,1701,7,1960
2020-03-24,IN,365,2566,12,2931
2020-03-25,IN,477,2879,14,3356
2020-03-26,IN,645,4006,17,4651
2020-03-27,IN,981,5955,24,6936
2020-03-28,IN,1232,7175,31,8407
2020-03-29,IN,1514,8316,32,9830
2020-03-30,IN,1786,9872,35,11658
2020-03-31,IN,2159,11214,49,13373
2020-04-01,IN,2565,11810,65,14375
2020-04-02,IN,3039,13246,78,16285
2020-04-03,IN,3437,14398,102,17835
2020-04-04,IN,3953,15847,116,19800
2020-04-05,IN,4411,18241,127,22652
2020-04-06,IN,4944,21247,139,26191
2020-04-07,IN,5507,23257,173,28764
2020-04-08,IN,5943,24926,203,30869
2020-04-09,IN,6351,25782,245,32133
2020-04-10,IN,6907,28133,300,35040
2020-04-11,IN,7435,31780,330,39215
2020-04-12,IN,7928,34561,343,42489
2020-04-13,IN,8236,36303,350,44539
2020-04-14,IN,8527,37490,388,46017
2020-04-15,IN,8955,39441,436,48396
2020-04-16,IN,9542,41573,477,51115
2020-04-17,IN,10154,44631,519,54785
2020-04-18,IN,10641,46232,545,56873
2020-04-19,IN,11210,49932,562,61142
2020-04-20,IN,11686,52953,569,64639
2020-04-21,IN,12097,55167,630,67264
2020-04-22,IN,12438,57032,661,69470
2020-04-23,IN,13039,59001,706,72040
2020-04-24,IN,13680,61873,741,75553
2020-04-25,IN,14395,65379,785,79774
2020-04-26,IN,15012,66696,813,81708
2020-04-27,IN,15961,68515,844,84476
2020-04-28,IN,16588,70593,901,87181
2020-04-29,IN,17182,74368,1065,91550
2020-04-30,IN,17835,77163,1114,94998
2020-05-01,IN,18630,81009,1175,99639
2020-05-02,IN,19295,84846,1229,104141
2020-05-03,IN,19933,88926,1246,108859
2020-05-04,IN,20507,92790,1264,113297
2020-05-05,IN,21033,94801,1326,115834
2020-05-06,IN,21870,98626,1377,120496
2020-05-07,IN,22503,102279,1414,124782
2020-05-08,IN,23146,106982,1447,130128
2020-05-09,IN,23732,111954,1490,135686
2020-05-10,IN,24126,115903,1508,140029
2020-05-11,IN,24627,122061,1540,146688
2020-05-12,IN,25127,125383,1578,150510
2020-05-13,IN,25473,128610,1619,154083
2020-05-14,IN,26053,134186,1646,160239
2020-05-15,IN,26655,138793,1691,165448
2020-05-16,IN,27280,144078,1741,171358
2020-05-17,IN,27778,149465,1751,177243
2020-05-18,IN,28255,155657,1765,183912
2020-05-19,IN,28705,160625,1824,189330
2020-05-20,IN,29274,166464,1864,195738
2020-05-21,IN,29936,173059,1913,202995
2020-05-22,IN,30409,178152,1941,208561
2020-05-23,IN,30901,184032,1943,214933
2020-05-24,IN,31376,189425,1976,220801
2020-05-25,IN,31715,194536,1976,226251
2020-05-26,IN,32078,198671,2004,230749
2020-05-27,IN,32437,202896,2030,235333
2020-05-28,IN,33068,209219,2068,242287
2020-05-29,IN,33558,215155,2110,248713
2020-05-30,IN,34211,222184,2125,256395
2020-05-31,IN,34574,226972,2134,261546
2020-06-01,IN,34830,231066,2142,265896
2020-06-02,IN,35237,236682,2197,271919
2020-06-03,IN,35712,242103,2207,277815
2020-06-04,IN,36096,249138,2231,285234
2020-06-05,IN,36578,255060,2258,291638
2020-06-06,IN,36997,260533,2292,297530
2020-06-07,IN,37397,266866,2303,304263
2020-06-08,IN,37623,271880,2316,309503
2020-06-09,IN,38033,277357,2339,315390
2020-06-10,IN,38337,281757,2355,320094
2020-06-11,IN,38748,288594,2380,327342
2020-06-12,IN,39146,296034,2396,335180
2020-06-13,IN,39543,301094,2413,340637
2020-06-14,IN,39909,308482,2422,348391
2020-06-15,IN,40430,315399,2433,355829
2020-06-16,IN,40786,322959,2447,363745
2020-06-17,IN,41013,330169,2475,371182
2020-06-18,IN,41438,343284,2491,384722
2020-06-19,IN,41746,351141,2516,392887
2020-06-20,IN,42061,359741,2536,401802
2020-06-21,IN,42423,369497,2540,411920
2020-06-22,IN,42633,376283,2553,418916
2020-06-23,IN,42871,383505,2569,426376
2020-06-24,IN,43140,388743,2578,431883
2020-06-25,IN,43655,400597,2586,444252
2020-06-26,IN,44140,409750,2595,453890
2020-06-27,IN,44575,418442,2616,463017
2020-06-28,IN,44930,425605,2619,470535
2020-06-29,IN,45228,431291,2624,476519
2020-06-30,IN,45594,438602,2640,484196
2020-07-01,IN,45952,443764,2650,489716
2020-07-02,IN,46387,450448,2662,496835
2020-07-03,IN,46915,457238,2681,504153
2020-07-04,IN,47432,464856,2687,512288
2020-07-05,IN,48008,473714,2693,521722
2020-07-06,IN,48331,478261,2698,526592
2020-07-07,IN,48626,481449,2717,530075
2020-07-08,IN,49063,486794,2732,535857
2020-07-09,IN,49575,492717,2739,542292
2020-07-10,IN,50300,500262,2748,550562
2020-07-11,IN,51079,507067,2756,558146
2020-07-12,IN,51612,513035,2760,564647
2020-07-13,IN,52037,518372,2762,570409
2020-07-14,IN,52685,525724,2775,578409
2020-07-15,IN,53370,533219,2785,586589
2020-07-16,IN,54080,541478,2795,595558
2020-07-17,IN,54813,549822,2803,604635
2020-07-18,IN,55654,558801,2820,614455
2020-07-19,IN,56571,570309,2822,626880
2020-07-20,IN,57206,578454,2825,635660
2020-07-21,IN,57916,586889,2846,644805
2020-07-22,IN,58673,595740,2863,654413
2020-07-23,IN,59602,606681,2880,666283
2020-03-06,KS,0,4,0,4
2020-03-07,KS,0,11,0,11
2020-03-08,KS,1,11,0,12
2020-03-09,KS,1,11,0,12
2020-03-10,KS,1,17,0,18
2020-03-11,KS,1,41,0,42
2020-03-12,KS,4,41,0,45
2020-03-13,KS,6,93,0,99
2020-03-14,KS,6,93,1,99
2020-03-15,KS,8,135,1,143
2020-03-16,KS,11,166,1,177
2020-03-17,KS,15,382,1,397
2020-03-18,KS,16,417,1,433
2020-03-19,KS,34,417,1,451
2020-03-20,KS,44,417,1,461
2020-03-21,KS,55,417,2,472
2020-03-22,KS,64,417,2,481
2020-03-23,KS,82,417,2,499
2020-03-24,KS,98,2086,2,2184
2020-03-25,KS,126,2360,3,2486
2020-03-26,KS,168,2869,3,3037
2020-03-27,KS,202,3229,4,3431
2020-03-28,KS,261,3671,5,3932
2020-03-29,KS,319,4194,6,4513
2020-03-30,KS,368,4554,8,4922
2020-03-31,KS,428,4996,9,5424
2020-04-01,KS,482,5411,10,5893
2020-04-02,KS,552,6059,13,6611
2020-04-03,KS,620,6454,17,7074
2020-04-04,KS,698,6880,21,7578
2020-04-05,KS,747,7476,22,8223
2020-04-06,KS,845,8239,25,9084
2020-04-07,KS,900,8614,27,9514
2020-04-08,KS,1046,9137,38,10183
2020-04-09,KS,1106,9669,42,10775
2020-04-10,KS,1166,10248,50,11414
2020-04-11,KS,1268,11075,55,12343
2020-04-12,KS,1337,11916,56,13253
2020-04-13,KS,1376,12488,62,13864
2020-04-14,KS,1426,12721,69,14147
2020-04-15,KS,1494,13174,76,14668
2020-04-16,KS,1588,14534,80,16122
2020-04-17,KS,1705,15196,84,16901
2020-04-18,KS,1790,15886,86,17676
2020-04-19,KS,1849,16281,92,18130
2020-04-20,KS,1986,16775,100,18761
2020-04-21,KS,2025,17076,107,19101
2020-04-22,KS,2211,17992,110,20203
2020-04-23,KS,2482,18836,112,21318
2020-04-24,KS,2777,20811,111,23588
2020-04-25,KS,3056,22143,117,25199
2020-04-26,KS,3174,23053,118,26227
2020-04-27,KS,3328,23839,120,27167
2020-04-28,KS,3491,24599,124,28090
2020-04-29,KS,3738,25720,125,29458
2020-04-30,KS,4238,27388,129,31626
2020-05-01,KS,4449,28585,130,33034
2020-05-02,KS,4746,30196,131,34942
2020-05-03,KS,5030,31748,134,36778
2020-05-04,KS,5245,33358,136,38603
2020-05-05,KS,5458,34634,137,40092
2020-05-06,KS,5734,36380,144,42114
2020-05-07,KS,6144,38678,147,44822
2020-05-08,KS,6501,41207,152,47708
2020-05-09,KS,6751,43182,157,49933
2020-05-10,KS,6948,45557,157,52505
2020-05-11,KS,7116,46993,158,54109
2020-05-12,KS,7116,46993,158,54109
2020-05-13,KS,7468,50160,164,57628
2020-05-14,KS,7468,50160,164,57628
2020-05-15,KS,7886,53706,172,61592
2020-05-16,KS,7886,53706,172,61592
2020-05-17,KS,7886,53706,172,61592
2020-05-18,KS,8340,58650,173,66990
2020-05-19,KS,8340,58650,173,66990
2020-05-20,KS,8539,62664,178,71203
2020-05-21,KS,8539,62664,178,71203
2020-05-22,KS,8958,67476,185,76434
2020-05-23,KS,8958,67476,185,76434
2020-05-24,KS,8958,67476,185,76434
2020-05-25,KS,9218,72181,188,81399
2020-05-26,KS,9218,72181,188,81399
2020-05-27,KS,9337,75151,205,84488
2020-05-28,KS,9337,75151,205,84488
2020-05-29,KS,9719,85230,208,94949
2020-05-30,KS,9719,85230,208,94949
2020-05-31,KS,9719,85230,208,94949
2020-06-01,KS,10011,85230,217,95241
2020-06-02,KS,10011,93301,217,103312
2020-06-03,KS,10170,97883,222,108053
2020-06-04,KS,10170,97883,222,108053
2020-06-05,KS,10393,103260,232,113653
2020-06-06,KS,10393,103260,232,113653
2020-06-07,KS,10393,103260,232,113653
2020-06-08,KS,10650,108859,236,119509
2020-06-09,KS,10650,108859,236,119509
2020-06-10,KS,10812,112930,240,123742
2020-06-11,KS,10812,112930,240,123742
2020-06-12,KS,11047,118105,243,129152
2020-06-13,KS,11047,118105,243,129152
2020-06-14,KS,11047,118105,243,129152
2020-06-15,KS,11419,125543,245,136962
2020-06-16,KS,11419,125543,245,136962
2020-06-17,KS,11681,130443,247,142124
2020-06-18,KS,11681,130443,247,142124
2020-06-19,KS,12059,135590,254,147649
2020-06-20,KS,12059,135590,254,147649
2020-06-21,KS,12059,135590,254,147649
2020-06-22,KS,12465,142548,259,155013
2020-06-23,KS,12465,142548,259,155013
2020-06-24,KS,12970,148735,261,161705
2020-06-25,KS,12970,148735,261,161705
2020-06-26,KS,13538,154321,264,167859
2020-06-27,KS,13538,154321,264,167859
2020-06-28,KS,13538,154321,264,167859
2020-06-29,KS,14443,162282,270,176725
2020-06-30,KS,14443,162282,270,176725
2020-07-01,KS,14990,168183,272,183173
2020-07-02,KS,14990,168183,272,183173
2020-07-03,KS,15919,175642,277,191561
2020-07-04,KS,15919,175642,277,191561
2020-07-05,KS,15919,175642,277,191561
2020-07-06,KS,16901,185318,280,202219
2020-07-07,KS,16901,185318,280,202219
2020-07-08,KS,17618,190864,282,208482
2020-07-09,KS,17618,190864,282,208482
2020-07-10,KS,18611,199168,284,217779
2020-07-11,KS,18611,199168,284,217779
2020-07-12,KS,18611,199168,284,217779
2020-07-13,KS,20058,211117,288,231175
2020-07-14,KS,20058,211117,288,231175
2020-07-15,KS,20933,218441,299,239374
2020-07-16,KS,20933,218441,299,239374
2020-07-17,KS,21965,227388,299,249353
2020-07-18,KS,21965,227388,299,249353
2020-07-19,KS,21965,227388,299,249353
2020-07-20,KS,23334,238197,307,261531
2020-07-21,KS,23334,238197,307,261531
2020-07-22,KS,24104,244582,308,268686
2020-07-23,KS,24104,244582,308,268686
2020-03-06,KY,0,7,0,7
2020-03-07,KY,1,9,0,10
2020-03-08,KY,1,13,0,14
2020-03-09,KY,4,17,0,21
2020-03-10,KY,6,28,0,34
2020-03-11,KY,8,46,0,54
2020-03-12,KY,8,56,0,64
2020-03-13,KY,11,107,0,118
2020-03-14,KY,14,139,1,153
2020-03-15,KY,16,139,1,155
2020-03-16,KY,21,234,1,255
2020-03-17,KY,22,295,1,317
2020-03-18,KY,26,354,1,380
2020-03-19,KY,35,454,1,489
2020-03-20,KY,47,592,1,639
2020-03-21,KY,54,714,2,768
2020-03-22,KY,99,1472,3,1571
2020-03-23,KY,104,1762,3,1866
2020-03-24,KY,124,1762,4,1886
2020-03-25,KY,157,2865,4,3022
2020-03-26,KY,198,3102,4,3300
2020-03-27,KY,248,3768,6,4016
2020-03-28,KY,302,4821,8,5123
2020-03-29,KY,394,5147,9,5541
2020-03-30,KY,439,5579,9,6018
2020-03-31,KY,480,6330,11,6810
2020-04-01,KY,591,6965,17,7556
2020-04-02,KY,680,7220,20,7900
2020-04-03,KY,770,12034,31,12804
2020-04-04,KY,831,14741,37,15572
2020-04-05,KY,917,15746,40,16663
2020-04-06,KY,955,17812,45,18767
2020-04-07,KY,1008,18947,59,19955
2020-04-08,KY,1149,20455,65,21604
2020-04-09,KY,1346,20455,73,21801
2020-04-10,KY,1693,22595,90,24288
2020-04-11,KY,1693,22595,90,24288
2020-04-12,KY,1840,22727,94,24567
2020-04-13,KY,1963,23903,97,25866
2020-04-14,KY,2048,24635,104,26683
2020-04-15,KY,2210,25487,115,27697
2020-04-16,KY,2291,26033,122,28324
2020-04-17,KY,2429,27318,129,29747
2020-04-18,KY,2522,28074,137,30596
2020-04-19,KY,2707,29518,144,32225
2020-04-20,KY,2960,29612,148,32572
2020-04-21,KY,3050,29770,154,32820
2020-04-22,KY,3192,30136,171,33328
2020-04-23,KY,3373,32702,185,36075
2020-04-24,KY,3481,39363,191,42844
2020-04-25,KY,3779,41183,200,44962
2020-04-26,KY,3905,42653,205,46558
2020-04-27,KY,4074,44400,208,48474
2020-04-28,KY,4146,44653,213,48799
2020-04-29,KY,4375,48036,225,52411
2020-04-30,KY,4539,49562,235,54101
2020-05-01,KY,4708,51904,240,56612
2020-05-02,KY,4879,52770,248,57649
2020-05-03,KY,4879,52770,248,57649
2020-05-04,KY,5130,53279,253,58409
2020-05-05,KY,5245,54802,261,60047
2020-05-06,KY,5822,55192,275,61014
2020-05-07,KY,5934,72672,283,78606
2020-05-08,KY,6129,75272,294,81401
2020-05-09,KY,6288,80159,298,86447
2020-05-10,KY,6440,80483,304,86923
2020-05-11,KY,6440,80483,304,86923
2020-05-12,KY,6677,97347,311,104024
2020-05-13,KY,6853,103781,321,110634
2020-05-14,KY,7080,110315,326,117395
2020-05-15,KY,7225,114053,328,121278
2020-05-16,KY,7444,120290,332,127734
2020-05-17,KY,7688,121997,334,129685
2020-05-18,KY,7688,121997,334,129685
2020-05-19,KY,8069,145917,366,153986
2020-05-20,KY,8069,145917,366,153986
2020-05-21,KY,8167,150505,376,158672
2020-05-22,KY,8286,157954,386,166240
2020-05-23,KY,8426,163033,391,171459
2020-05-24,KY,8571,161285,391,169856
2020-05-25,KY,8571,161285,391,169856
2020-05-26,KY,8571,161285,391,169856
2020-05-27,KY,9077,173024,400,182101
2020-05-28,KY,9077,173024,400,182101
2020-05-29,KY,9184,212090,409,221274
2020-05-30,KY,9464,198731,418,208195
2020-05-31,KY,9704,204049,431,213753
2020-06-01,KY,10046,206000,439,216046
2020-06-02,KY,10185,217086,442,227271
2020-06-03,KY,10410,221789,450,232199
2020-06-04,KY,10705,225220,458,235925
2020-06-05,KY,10977,231440,466,242417
2020-06-06,KY,11287,237775,470,249062
2020-06-07,KY,11287,237775,470,249062
2020-06-08,KY,11476,241381,472,252857
2020-06-09,KY,11708,248230,477,259938
2020-06-10,KY,11883,262531,484,274414
2020-06-11,KY,11945,269149,493,281094
2020-06-12,KY,11945,269149,493,281094
2020-06-13,KY,12445,282140,499,294585
2020-06-14,KY,12445,282140,499,294585
2020-06-15,KY,12647,283204,505,295851
2020-06-16,KY,12829,283204,512,296033
2020-06-17,KY,12995,286874,518,299869
2020-06-18,KY,13197,293183,520,306380
2020-06-19,KY,13454,297773,522,311227
2020-06-20,KY,13630,303531,524,317161
2020-06-21,KY,13750,303531,526,317281
2020-06-22,KY,13839,308193,526,322032
2020-06-23,KY,14141,317153,537,331294
2020-06-24,KY,14363,321339,538,335702
2020-06-25,KY,14617,328265,546,342882
2020-06-26,KY,14859,335895,553,350754
2020-06-27,KY,14859,335895,553,350754
2020-06-28,KY,15232,343259,558,358491
2020-06-29,KY,15347,346094,560,361441
2020-06-30,KY,15624,355310,565,370934
2020-07-01,KY,15842,361248,572,377090
2020-07-02,KY,16079,369715,581,385794
2020-07-03,KY,16376,379271,585,395647
2020-07-04,KY,16376,379271,585,395647
2020-07-05,KY,16376,379271,585,395647
2020-07-06,KY,17152,383190,593,400342
2020-07-07,KY,17519,392353,602,409872
2020-07-08,KY,17919,398002,608,415921
2020-07-09,KY,18245,405768,612,424013
2020-07-10,KY,18670,414020,620,432690
2020-07-11,KY,19121,418781,622,437902
2020-07-12,KY,19389,418781,625,438170
2020-07-13,KY,19653,422232,629,441885
2020-07-14,KY,20223,435333,635,455556
2020-07-15,KY,20677,438510,645,459187
2020-07-16,KY,21083,446921,650,468004
2020-07-17,KY,21605,461457,658,483062
2020-07-18,KY,22184,468017,667,490201
2020-07-19,KY,23161,469563,670,492724
2020-07-20,KY,23414,470740,671,494154
2020-07-21,KY,24060,484633,674,508693
2020-07-22,KY,24540,494535,677,519075
2020-07-23,KY,25147,499648,684,524795
2020-03-07,LA,0,0,0,0
2020-03-08,LA,0,5,0,5
2020-03-09,LA,1,5,0,6
2020-03-10,LA,1,11,0,12
2020-03-11,LA,6,37,0,43
2020-03-12,LA,14,37,0,51
2020-03-13,LA,36,37,0,73
2020-03-14,LA,51,109,0,160
2020-03-15,LA,90,156,2,246
2020-03-16,LA,115,188,2,303
2020-03-17,LA,137,286,4,423
2020-03-18,LA,240,335,6,575
2020-03-19,LA,347,458,8,805
2020-03-20,LA,473,568,12,1041
2020-03-21,LA,580,2180,16,2760
2020-03-22,LA,837,2661,20,3498
2020-03-23,LA,1172,4776,34,5948
2020-03-24,LA,1388,7215,46,8603
2020-03-25,LA,1795,9656,65,11451
2020-03-26,LA,2305,15724,83,18029
2020-03-27,LA,2746,18613,119,21359
2020-03-28,LA,3315,21846,137,25161
2020-03-29,LA,3540,24331,151,27871
2020-03-30,LA,4025,30008,185,34033
2020-03-31,LA,5237,33730,239,38967
2020-04-01,LA,6424,39352,273,45776
2020-04-02,LA,9150,41936,310,51086
2020-04-03,LA,10297,43348,370,53645
2020-04-04,LA,12496,46002,409,58498
2020-04-05,LA,13010,47315,477,60325
2020-04-06,LA,14867,54299,512,69166
2020-04-07,LA,16284,58371,582,74655
2020-04-08,LA,17030,64376,652,81406
2020-04-09,LA,18283,68636,702,86919
2020-04-10,LA,19253,73027,755,92280
2020-04-11,LA,20014,76901,806,96915
2020-04-12,LA,20595,83450,840,104045
2020-04-13,LA,21016,87075,884,108091
2020-04-14,LA,21518,96904,1013,118422
2020-04-15,LA,21951,99977,1103,121928
2020-04-16,LA,22532,104054,1156,126586
2020-04-17,LA,23118,108869,1213,131987
2020-04-18,LA,23580,114419,1267,137999
2020-04-19,LA,23928,111420,1296,135348
2020-04-20,LA,24523,111588,1328,136111
2020-04-21,LA,24854,111588,1405,136442
2020-04-22,LA,25258,111588,1473,136846
2020-04-23,LA,25739,111774,1540,137513
2020-04-24,LA,26140,111972,1601,138112
2020-04-25,LA,26512,112490,1644,139002
2020-04-26,LA,26773,116263,1670,143036
2020-04-27,LA,27068,119921,1697,146989
2020-04-28,LA,27286,123822,1758,151108
2020-04-29,LA,27660,128908,1802,156568
2020-04-30,LA,28001,133308,1862,161309
2020-05-01,LA,28711,139540,1927,168251
2020-05-02,LA,29140,143718,1950,172858
2020-05-03,LA,29340,146820,1969,176160
2020-05-04,LA,29673,151258,2064,180931
2020-05-05,LA,29996,158235,2115,188231
2020-05-06,LA,30399,164273,2115,194672
2020-05-07,LA,30652,170115,2208,200767
2020-05-08,LA,30855,171561,2227,202416
2020-05-09,LA,31417,180740,2267,212157
2020-05-10,LA,31600,184272,2286,215872
2020-05-11,LA,31815,189015,2308,220830
2020-05-12,LA,32050,195962,2347,228012
2020-05-13,LA,32662,205242,2381,237904
2020-05-14,LA,33489,214099,2417,247588
2020-05-15,LA,33837,219352,2448,253189
2020-05-16,LA,34117,225625,2479,259742
2020-05-17,LA,34432,230738,2491,265170
2020-05-18,LA,34709,235039,2563,269748
2020-05-19,LA,35038,243035,2581,278073
2020-05-20,LA,35316,250654,2608,285970
2020-05-21,LA,36504,268877,2629,305381
2020-05-22,LA,36925,274883,2668,311808
2020-05-23,LA,37040,277407,2668,314447
2020-05-24,LA,37169,278867,2690,316036
2020-05-25,LA,37809,293089,2690,330898
2020-05-26,LA,38054,302972,2701,341026
2020-05-27,LA,38497,309150,2722,347647
2020-05-28,LA,38802,316225,2740,355027
2020-05-29,LA,38802,316225,2766,355027
2020-05-30,LA,39577,329242,2785,368819
2020-05-31,LA,39916,335193,2791,375109
2020-06-01,LA,40341,347029,2801,387370
2020-06-02,LA,40746,352387,2835,393133
2020-06-03,LA,41133,360954,2870,402087
2020-06-04,LA,41562,369624,2883,411186
2020-06-05,LA,41989,378797,2912,420786
2020-06-06,LA,42486,385583,2925,428069
2020-06-07,LA,42816,391249,2936,434065
2020-06-08,LA,43050,399552,2944,442602
2020-06-09,LA,43612,410056,2957,453668
2020-06-10,LA,44030,416090,2968,460120
2020-06-11,LA,44472,425201,2987,469673
2020-06-12,LA,44995,434539,2996,479534
2020-06-13,LA,46283,458100,3004,504383
2020-06-14,LA,46619,462713,3014,509332
2020-06-15,LA,47172,471553,3018,518725
2020-06-16,LA,47706,485011,3042,532717
2020-06-17,LA,48634,496587,3062,545221
2020-06-18,LA,48634,496587,3062,545221
2020-06-19,LA,48515,542394,3084,590909
2020-06-20,LA,49385,555431,3104,604816
2020-06-21,LA,49778,561034,3105,610812
2020-06-22,LA,50239,567825,3117,618064
2020-06-23,LA,51595,584344,3134,635939
2020-06-24,LA,52477,596028,3152,648505
2020-06-25,LA,53415,607250,3164,660665
2020-06-26,LA,54769,623237,3190,678006
2020-06-27,LA,54769,623237,3190,678006
2020-06-28,LA,56236,639875,3199,696111
2020-06-29,LA,57081,647556,3199,704637
2020-06-30,LA,58095,670416,3221,728511
2020-07-01,LA,60178,691910,3238,752088
2020-07-02,LA,61561,705813,3255,767374
2020-07-03,LA,63289,720853,3278,784142
2020-07-04,LA,63289,720853,3278,784142
2020-07-05,LA,65226,737228,3288,802454
2020-07-06,LA,66327,747318,3296,813645
2020-07-07,LA,68263,779335,3319,847598
2020-07-08,LA,70151,795586,3339,865737
2020-07-09,LA,71994,808146,3355,880140
2020-07-10,LA,74636,830612,3380,905248
2020-07-11,LA,76803,847644,3403,924447
2020-07-12,LA,78122,856873,3416,934995
2020-07-13,LA,79827,873599,3423,953426
2020-07-14,LA,82042,894413,3445,976455
2020-07-15,LA,84131,917069,3461,1001200
2020-07-16,LA,86411,937726,3485,1024137
2020-07-17,LA,88590,955350,3509,1043940
2020-07-18,LA,88590,955350,3509,1043940
2020-07-19,LA,91706,977598,3543,1069304
2020-07-20,LA,94892,1008032,3572,1102924
2020-07-21,LA,96583,1026379,3608,1122962
2020-07-22,LA,99354,1053547,3670,1152901
2020-07-23,LA,101650,1073218,3686,1174868
2020-03-12,MA,8,0,0,8
2020-03-13,MA,23,0,0,23
2020-03-14,MA,38,0,0,38
2020-03-15,MA,64,584,0,648
2020-03-16,MA,97,1199,0,1296
2020-03-17,MA,118,1633,0,1751
2020-03-18,MA,156,2115,2,2271
2020-03-19,MA,229,2918,3,3147
2020-03-20,MA,314,3795,5,4109
2020-03-21,MA,426,4799,7,5225
2020-03-22,MA,547,5476,11,6023
2020-03-23,MA,678,8263,17,8941
2020-03-24,MA,1060,12714,26,13774
2020-03-25,MA,1739,18079,33,19818
2020-03-26,MA,2318,21327,42,23645
2020-03-27,MA,3151,26244,57,29395
2020-03-28,MA,4158,30915,72,35073
2020-03-29,MA,4856,34234,99,39090
2020-03-30,MA,5653,37166,124,42819
2020-03-31,MA,6521,40440,153,46961
2020-04-01,MA,7639,44125,187,51764
2020-04-02,MA,8867,47767,229,56634
2020-04-03,MA,10303,52685,265,62988
2020-04-04,MA,11637,57191,304,68828
2020-04-05,MA,12402,59565,370,71967
2020-04-06,MA,13739,62720,448,76459
2020-04-07,MA,15104,66270,515,81374
2020-04-08,MA,16692,70849,615,87541
2020-04-09,MA,18843,76146,725,94989
2020-04-10,MA,20878,81564,832,102442
2020-04-11,MA,22766,86115,946,108881
2020-04-12,MA,25381,91463,1056,116844
2020-04-13,MA,26794,95500,1211,122294
2020-04-14,MA,28109,98820,1329,126929
2020-04-15,MA,29970,102790,1502,132760
2020-04-16,MA,32492,110098,1667,142590
2020-04-17,MA,35125,117195,1822,152320
2020-04-18,MA,37527,124604,1983,162131
2020-04-19,MA,39820,129295,2146,169115
2020-04-20,MA,41416,136046,2303,177462
2020-04-21,MA,43168,141444,2449,184612
2020-04-22,MA,44913,144789,2597,189702
2020-04-23,MA,47992,156324,2769,204316
2020-04-24,MA,50969,164244,2877,215213
2020-04-25,MA,53348,173497,2877,226845
2020-04-26,MA,54938,181162,2899,236100
2020-04-27,MA,56462,188425,3003,244887
2020-04-28,MA,58302,196198,3153,254500
2020-04-29,MA,60265,205353,3405,265618
2020-04-30,MA,62205,213442,3562,275647
2020-05-01,MA,64311,225325,3716,289636
2020-05-02,MA,66263,232731,3846,298994
2020-05-03,MA,68087,246559,4004,314646
2020-05-04,MA,69087,255181,4090,324268
2020-05-05,MA,70271,263078,4212,333349
2020-05-06,MA,72025,267614,4420,339639
2020-05-07,MA,73721,277911,4552,351632
2020-05-08,MA,75333,290690,4702,366023
2020-05-09,MA,76743,299794,4840,376537
2020-05-10,MA,77793,310596,4979,388389
2020-05-11,MA,78462,316266,5108,394728
2020-05-12,MA,79332,322164,5141,401496
2020-05-13,MA,80497,329535,5315,410032
2020-05-14,MA,82182,342179,5482,424361
2020-05-15,MA,83421,352258,5592,435679
2020-05-16,MA,84933,363156,5705,448089
2020-05-17,MA,86010,374816,5797,460826
2020-05-18,MA,87052,382147,5862,469199
2020-05-19,MA,87925,389015,5938,476940
2020-05-20,MA,88970,400983,6066,489953
2020-05-21,MA,90084,411402,6148,501486
2020-05-22,MA,90889,420755,6228,511644
2020-05-23,MA,91662,429324,6304,520986
2020-05-24,MA,92675,439698,6372,532373
2020-05-25,MA,93271,447290,6416,540561
2020-05-26,MA,93693,451788,6473,545481
2020-05-27,MA,94220,457924,6547,552144
2020-05-28,MA,94895,467428,6640,562323
2020-05-29,MA,95512,476233,6718,571745
2020-05-30,MA,96301,486218,6768,582519
2020-05-31,MA,96965,495888,6846,592853
2020-06-01,MA,100805,502628,7035,603433
2020-06-02,MA,101163,508232,7085,609395
2020-06-03,MA,101592,516169,7152,617761
2020-06-04,MA,102063,522872,7201,624935
2020-06-05,MA,102557,532212,7235,634769
2020-06-06,MA,103132,541507,7289,644639
2020-06-07,MA,103436,549054,7316,652490
2020-06-08,MA,103626,553643,7353,657269
2020-06-09,MA,103889,558103,7408,661992
2020-06-10,MA,104156,567934,7454,672090
2020-06-11,MA,104667,578421,7492,683088
2020-06-12,MA,105059,588300,7538,693359
2020-06-13,MA,105395,598201,7576,703596
2020-06-14,MA,105603,607107,7624,712710
2020-06-15,MA,105690,611541,7647,717231
2020-06-16,MA,105885,617762,7665,723647
2020-06-17,MA,106151,625895,7734,732046
2020-06-18,MA,106422,634838,7770,741260
2020-06-19,MA,106650,644157,7800,750807
2020-06-20,MA,106936,658001,7828,764937
2020-06-21,MA,107061,666259,7858,773320
2020-06-22,MA,107210,672853,7874,780063
2020-06-23,MA,107439,680203,7890,787642
2020-06-24,MA,107611,687461,7938,795072
2020-06-25,MA,107837,697619,7963,805456
2020-06-26,MA,108070,706015,8013,814085
2020-06-27,MA,108443,717899,8041,826342
2020-06-28,MA,108667,727127,8060,835794
2020-06-29,MA,108768,733519,8095,842287
2020-06-30,MA,108882,739259,8054,848141
2020-07-01,MA,109143,749292,8081,858435
2020-07-02,MA,109338,756920,8132,866258
2020-07-03,MA,109628,768152,8149,877780
2020-07-04,MA,109838,775929,8172,885767
2020-07-05,MA,109974,781711,8183,891685
2020-07-06,MA,110137,789280,8198,899417
2020-07-07,MA,110338,796422,8213,906760
2020-07-08,MA,110602,805393,8243,915995
2020-07-09,MA,110897,814864,8268,925761
2020-07-10,MA,111110,827506,8296,938616
2020-07-11,MA,111398,834936,8310,946334
2020-07-12,MA,111597,845883,8325,957480
2020-07-13,MA,111827,854316,8330,966143
2020-07-14,MA,112130,866084,8340,978214
2020-07-15,MA,112347,876366,8368,988713
2020-07-16,MA,112581,889103,8380,1001684
2020-07-17,MA,112879,901708,8402,1014587
2020-07-18,MA,113238,913595,8419,1026833
2020-07-19,MA,113534,927001,8431,1040535
2020-07-20,MA,113789,937492,8433,1051281
2020-07-21,MA,114033,945148,8450,1059181
2020-07-22,MA,114320,955742,8468,1070062
2020-07-23,MA,114320,955742,8468,1070062
2020-03-05,MD,0,17,0,17
2020-03-06,MD,3,26,0,29
2020-03-07,MD,3,41,0,44
2020-03-08,MD,3,52,0,55
2020-03-09,MD,5,73,0,78
2020-03-10,MD,6,89,0,95
2020-03-11,MD,9,94,0,103
2020-03-12,MD,12,94,0,106
2020-03-13,MD,17,94,0,111
2020-03-14,MD,26,94,0,120
2020-03-15,MD,31,94,0,125
2020-03-16,MD,37,94,2,131
2020-03-17,MD,57,94,0,151
2020-03-18,MD,85,94,2,179
2020-03-19,MD,107,94,2,201
2020-03-20,MD,149,94,3,243
2020-03-21,MD,190,94,3,284
2020-03-22,MD,244,94,4,338
2020-03-23,MD,288,94,4,382
2020-03-24,MD,349,94,5,443
2020-03-25,MD,423,94,5,517
2020-03-26,MD,580,94,7,674
2020-03-27,MD,774,94,10,868
2020-03-28,MD,992,11516,17,12508
2020-03-29,MD,1239,12354,24,13593
2020-03-30,MD,1413,13316,35,14729
2020-03-31,MD,1660,14868,43,16528
2020-04-01,MD,1985,17233,52,19218
2020-04-02,MD,2331,18890,64,21221
2020-04-03,MD,2758,20932,84,23690
2020-04-04,MD,3125,22485,101,25610
2020-04-05,MD,3609,24728,122,28337
2020-04-06,MD,4045,25572,138,29617
2020-04-07,MD,4371,27256,160,31627
2020-04-08,MD,5529,32933,191,38462
2020-04-09,MD,6185,35344,221,41529
2020-04-10,MD,6968,37480,255,44448
2020-04-11,MD,7694,39544,298,47238
2020-04-12,MD,8225,41539,335,49764
2020-04-13,MD,8936,42815,384,51751
2020-04-14,MD,9472,44261,421,53733
2020-04-15,MD,10032,45731,469,55763
2020-04-16,MD,10784,48059,499,58843
2020-04-17,MD,11572,50437,541,62009
2020-04-18,MD,12308,53062,582,65370
2020-04-19,MD,12830,55061,626,67891
2020-04-20,MD,13684,57713,683,71397
2020-04-21,MD,14193,59442,732,73635
2020-04-22,MD,14775,61754,779,76529
2020-04-23,MD,15737,64363,831,80100
2020-04-24,MD,16616,68100,899,84716
2020-04-25,MD,17766,71357,948,89123
2020-04-26,MD,18581,78084,1001,96665
2020-04-27,MD,19487,85489,1045,104976
2020-04-28,MD,20113,87672,1099,107785
2020-04-29,MD,20849,90080,1168,110929
2020-04-30,MD,21742,92617,1226,114359
2020-05-01,MD,23472,97511,1276,120983
2020-05-02,MD,24473,101049,1323,125522
2020-05-03,MD,25462,107332,1372,132794
2020-05-04,MD,26408,110587,1424,136995
2020-05-05,MD,27117,112986,1476,140103
2020-05-06,MD,28163,115849,1520,144012
2020-05-07,MD,29374,119226,1580,148600
2020-05-08,MD,30485,121702,1643,152187
2020-05-09,MD,31534,124494,1692,156028
2020-05-10,MD,32587,127344,1739,159931
2020-05-11,MD,33373,131407,1788,164780
2020-05-12,MD,34061,135442,1834,169503
2020-05-13,MD,34812,138762,1881,173574
2020-05-14,MD,35903,142551,1935,178454
2020-05-15,MD,36986,145840,1991,182826
2020-05-16,MD,37968,152207,2040,190175
2020-05-17,MD,38804,156122,2090,194926
2020-05-18,MD,39762,161744,2122,201506
2020-05-19,MD,41546,167112,2164,208658
2020-05-20,MD,42323,173007,2198,215330
2020-05-21,MD,43531,176702,2221,220233
2020-05-22,MD,44424,183478,2274,227902
2020-05-23,MD,45495,186832,2306,232327
2020-05-24,MD,46313,194049,2341,240362
2020-05-25,MD,47152,202425,2379,249577
2020-05-26,MD,47687,206800,2417,254487
2020-05-27,MD,48423,213632,2458,262055
2020-05-28,MD,49709,225149,2501,274858
2020-05-29,MD,50988,233530,2538,284518
2020-05-30,MD,52015,241931,2562,293946
2020-05-31,MD,52778,249103,2596,301881
2020-06-01,MD,53327,255403,2625,308730
2020-06-02,MD,54175,261640,2646,315815
2020-06-03,MD,54982,272643,2666,327625
2020-06-04,MD,55858,281160,2668,337018
2020-06-05,MD,56770,290956,2702,347726
2020-06-06,MD,57482,299894,2740,357376
2020-06-07,MD,57973,306830,2749,364803
2020-06-08,MD,58404,313099,2776,371503
2020-06-09,MD,58904,319178,2811,378082
2020-06-10,MD,59465,325177,2844,384642
2020-06-11,MD,60197,332173,2875,392370
2020-06-12,MD,60613,339482,2900,400095
2020-06-13,MD,61305,347453,2926,408758
2020-06-14,MD,61701,353608,2939,415309
2020-06-15,MD,62032,359076,2947,421108
2020-06-16,MD,62409,366816,2982,429225
2020-06-17,MD,62969,378374,2996,441343
2020-06-18,MD,63229,384379,3016,447608
2020-06-19,MD,63548,390121,3030,453669
2020-06-20,MD,63956,398324,3052,462280
2020-06-21,MD,64306,404725,3066,469031
2020-06-22,MD,64603,410122,3074,474725
2020-06-23,MD,65007,418528,3092,483535
2020-06-24,MD,65337,425120,3108,490457
2020-06-25,MD,65777,433182,3129,498959
2020-06-26,MD,66115,440282,3142,506397
2020-06-27,MD,66450,447366,3157,513816
2020-06-28,MD,66777,452696,3168,519473
2020-06-29,MD,67254,462059,3175,529313
2020-06-30,MD,67559,468296,3190,535855
2020-07-01,MD,67918,474686,3205,542604
2020-07-02,MD,68423,484752,3212,553175
2020-07-03,MD,68961,494873,3223,563834
2020-07-04,MD,69341,504001,3236,573342
2020-07-05,MD,69632,510330,3243,579962
2020-07-06,MD,69904,517457,3246,587361
2020-07-07,MD,70396,523982,3266,594378
2020-07-08,MD,70861,532247,3275,603108
2020-07-09,MD,71447,541134,3288,612581
2020-07-10,MD,71910,549153,3303,621063
2020-07-11,MD,72467,556810,3310,629277
2020-07-12,MD,73109,570282,3319,643391
2020-07-13,MD,73527,578430,3325,651957
2020-07-14,MD,74260,591809,3334,666069
2020-07-15,MD,75016,605072,3341,680088
2020-07-16,MD,75664,616865,3347,692529
2020-07-17,MD,76371,631845,3359,708216
2020-07-18,MD,77206,643780,3368,720986
2020-07-19,MD,78131,661654,3377,739785
2020-07-20,MD,78685,670594,3382,749279
2020-07-21,MD,79545,684822,3402,764367
2020-07-22,MD,80172,702661,3405,782833
2020-07-23,MD,80836,708205,3409,789041
2020-03-07,ME,0,1,0,1
2020-03-08,ME,0,1,0,1
2020-03-09,ME,0,1,0,1
2020-03-10,ME,0,20,0,20
2020-03-11,ME,0,42,0,42
2020-03-12,ME,1,65,0,66
2020-03-13,ME,3,91,0,94
2020-03-14,ME,3,91,0,94
2020-03-15,ME,3,91,0,94
2020-03-16,ME,17,764,0,781
2020-03-17,ME,32,1303,0,1335
2020-03-18,ME,43,1670,0,1713
2020-03-19,ME,53,2004,0,2057
2020-03-20,ME,57,2264,0,2321
2020-03-21,ME,73,2264,0,2337
2020-03-22,ME,89,2264,0,2353
2020-03-23,ME,107,2791,0,2898
2020-03-24,ME,125,3014,0,3139
2020-03-25,ME,149,3177,0,3326
2020-03-26,ME,155,3394,0,3549
2020-03-27,ME,168,3394,1,3562
2020-03-28,ME,211,3394,1,3605
2020-03-29,ME,253,3394,3,3647
2020-03-30,ME,275,3394,3,3669
2020-03-31,ME,303,6088,5,6391
2020-04-01,ME,344,6088,7,6432
2020-04-02,ME,376,6088,7,6464
2020-04-03,ME,432,6088,9,6520
2020-04-04,ME,456,6088,10,6544
2020-04-05,ME,470,6088,10,6558
2020-04-06,ME,499,6088,10,6587
2020-04-07,ME,519,6088,12,6607
2020-04-08,ME,537,6088,14,6625
2020-04-09,ME,560,6088,16,6648
2020-04-10,ME,586,6088,17,6674
2020-04-11,ME,616,6088,19,6704
2020-04-12,ME,633,6088,19,6721
2020-04-13,ME,698,11608,19,12306
2020-04-14,ME,734,11608,20,12342
2020-04-15,ME,770,14076,24,14846
2020-04-16,ME,796,14076,27,14872
2020-04-17,ME,827,14076,29,14903
2020-04-18,ME,847,14076,32,14923
2020-04-19,ME,867,14076,34,14943
2020-04-20,ME,875,14076,35,14951
2020-04-21,ME,888,14076,36,14964
2020-04-22,ME,907,16784,39,17691
2020-04-23,ME,937,16784,44,17721
2020-04-24,ME,965,16784,47,17749
2020-04-25,ME,990,16784,50,17774
2020-04-26,ME,1015,16784,50,17799
2020-04-27,ME,1023,16784,51,17807
2020-04-28,ME,1040,16784,51,17824
2020-04-29,ME,1056,19546,52,20602
2020-04-30,ME,1095,19546,53,20641
2020-05-01,ME,1123,19546,55,20669
2020-05-02,ME,1152,19546,56,20698
2020-05-03,ME,1185,19546,57,20731
2020-05-04,ME,1205,19546,57,20751
2020-05-05,ME,1226,19546,61,20772
2020-05-06,ME,1254,22092,62,23346
2020-05-07,ME,1330,22092,62,23422
2020-05-08,ME,1374,22092,63,23466
2020-05-09,ME,1408,22092,64,23500
2020-05-10,ME,1436,22092,64,23528
2020-05-11,ME,1462,22092,65,23554
2020-05-12,ME,1477,22092,65,23569
2020-05-13,ME,1515,22092,66,23607
2020-05-14,ME,1565,22092,69,23657
2020-05-15,ME,1603,22092,69,23695
2020-05-16,ME,1648,22092,70,23740
2020-05-17,ME,1687,22092,70,23779
2020-05-18,ME,1713,22092,71,23805
2020-05-19,ME,1741,22092,73,23833
2020-05-20,ME,1819,35450,73,37269
2020-05-21,ME,1877,35450,73,37327
2020-05-22,ME,1948,35450,75,37398
2020-05-23,ME,2013,35450,77,37463
2020-05-24,ME,2055,35450,78,37505
2020-05-25,ME,2074,35450,78,37524
2020-05-26,ME,2109,35450,79,37559
2020-05-27,ME,2137,43480,81,45617
2020-05-28,ME,2189,43480,84,45669
2020-05-29,ME,2226,43480,85,45706
2020-05-30,ME,2282,47284,89,49566
2020-05-31,ME,2325,47284,89,49609
2020-06-01,ME,2349,47284,89,49633
2020-06-02,ME,2377,50591,94,52968
2020-06-03,ME,2418,50591,95,53009
2020-06-04,ME,2446,53755,95,56201
2020-06-05,ME,2482,55050,98,57532
2020-06-06,ME,2524,56399,98,58923
2020-06-07,ME,2570,56399,99,58969
2020-06-08,ME,2588,59057,99,61645
2020-06-09,ME,2606,59814,100,62420
2020-06-10,ME,2637,61303,100,63940
2020-06-11,ME,2667,62790,100,65457
2020-06-12,ME,2721,64166,100,66887
2020-06-13,ME,2757,65593,100,68350
2020-06-14,ME,2793,67065,100,69858
2020-06-15,ME,2810,68161,101,70971
2020-06-16,ME,2819,69516,101,72335
2020-06-17,ME,2836,71182,102,74018
2020-06-18,ME,2878,71182,102,74060
2020-06-19,ME,2913,74248,102,77161
2020-06-20,ME,2938,76638,102,79576
2020-06-21,ME,2957,78033,102,80990
2020-06-22,ME,2971,78033,102,81004
2020-06-23,ME,2994,78713,102,81707
2020-06-24,ME,3017,82173,103,85190
2020-06-25,ME,3070,84528,103,87598
2020-06-26,ME,3102,86752,103,89854
2020-06-27,ME,3154,88778,104,91932
2020-06-28,ME,3191,90304,104,93495
2020-06-29,ME,3219,90304,105,93523
2020-06-30,ME,3253,91699,105,94952
2020-07-01,ME,3294,93947,105,97241
2020-07-02,ME,3328,97489,105,100817
2020-07-03,ME,3373,100076,105,103449
2020-07-04,ME,3397,102548,107,105945
2020-07-05,ME,3415,104517,109,107932
2020-07-06,ME,3423,106127,109,109550
2020-07-07,ME,3440,107466,110,110906
2020-07-08,ME,3460,109478,110,112938
2020-07-09,ME,3486,112272,111,115758
2020-07-10,ME,3499,114907,111,118406
2020-07-11,ME,3520,116370,112,119890
2020-07-12,ME,3539,118775,114,122314
2020-07-13,ME,3558,120404,114,123962
2020-07-14,ME,3566,121909,114,125475
2020-07-15,ME,3578,124353,114,127931
2020-07-16,ME,3598,126864,114,130462
2020-07-17,ME,3636,129809,115,133445
2020-07-18,ME,3646,131283,117,134929
2020-07-19,ME,3687,133750,117,137437
2020-07-20,ME,3711,135511,117,139222
2020-07-21,ME,3723,138520,118,142243
2020-07-22,ME,3723,141295,118,145018
2020-07-23,ME,3737,143938,118,147675
2020-03-01,MI,9,0,0,9
2020-03-02,MI,18,0,0,18
2020-03-03,MI,34,0,0,34
2020-03-04,MI,52,0,0,52
2020-03-05,MI,72,8,0,80
2020-03-06,MI,98,8,0,106
2020-03-07,MI,128,18,0,146
2020-03-08,MI,168,26,0,194
2020-03-09,MI,254,36,0,290
2020-03-10,MI,358,39,0,397
2020-03-11,MI,497,57,0,554
2020-03-12,MI,702,91,0,793
2020-03-13,MI,945,133,0,1078
2020-03-14,MI,1196,205,0,1401
2020-03-15,MI,1480,205,0,1685
2020-03-16,MI,1933,272,0,2205
2020-03-17,MI,3659,879,2,4538
2020-03-18,MI,4531,1478,5,6009
2020-03-19,MI,5276,2051,10,7327
2020-03-20,MI,6219,3041,13,9260
2020-03-21,MI,7023,4086,23,11109
2020-03-22,MI,7822,4791,36,12613
2020-03-23,MI,9062,5847,57,14909
2020-03-24,MI,10155,6989,86,17144
2020-03-25,MI,11335,8842,111,20177
2020-03-26,MI,12475,11730,159,24205
2020-03-27,MI,13799,14140,212,27939
2020-03-28,MI,14865,15902,283,30767
2020-03-29,MI,15784,17417,351,33201
2020-03-30,MI,17363,23263,437,40626
2020-03-31,MI,18654,26334,551,44988
2020-04-01,MI,20246,29951,676,50197
2020-04-02,MI,21376,33443,801,54819
2020-04-03,MI,22579,37060,918,59639
2020-04-04,MI,23581,41205,1030,64786
2020-04-05,MI,24458,44154,1150,68612
2020-04-06,MI,25785,47262,1291,73047
2020-04-07,MI,26964,50344,1449,77308
2020-04-08,MI,28064,53176,1600,81240
2020-04-09,MI,29096,56430,1756,85526
2020-04-10,MI,30172,59597,1917,89769
2020-04-11,MI,30980,62241,2081,93221
2020-04-12,MI,31666,64555,2249,96221
2020-04-13,MI,32702,67063,2391,99765
2020-04-14,MI,33613,70675,2532,104288
2020-04-15,MI,34533,73828,2672,108361
2020-04-16,MI,35455,78274,2841,113729
2020-04-17,MI,36320,83268,2984,119588
2020-04-18,MI,37029,87114,3107,124143
2020-04-19,MI,37557,89758,3236,127315
2020-04-20,MI,38494,93393,3347,131887
2020-04-21,MI,39589,99667,3471,139256
2020-04-22,MI,40705,106653,3602,147358
2020-04-23,MI,41694,115005,3711,156699
2020-04-24,MI,42730,123054,3818,165784
2020-04-25,MI,43263,128955,3929,172218
2020-04-26,MI,43789,134431,4036,178220
2020-04-27,MI,44709,140972,4148,185681
2020-04-28,MI,45538,148910,4247,194448
2020-04-29,MI,46488,158373,4335,204861
2020-04-30,MI,47505,168944,4434,216449
2020-05-01,MI,48240,178807,4520,227047
2020-05-02,MI,48672,188713,4579,237385
2020-05-03,MI,49029,195361,4641,244390
2020-05-04,MI,49809,202671,4722,252480
2020-05-05,MI,50497,213091,4781,263588
2020-05-06,MI,51131,224563,4839,275694
2020-05-07,MI,51731,236184,4925,287915
2020-05-08,MI,52349,248142,4987,300491
2020-05-09,MI,52732,259265,5036,311997
2020-05-10,MI,53033,267417,5081,320450
2020-05-11,MI,54004,278293,5139,332297
2020-05-12,MI,55641,291701,5188,347342
2020-05-13,MI,56458,310242,5232,366700
2020-05-14,MI,57036,326657,5278,383693
2020-05-15,MI,57687,341827,5325,399514
2020-05-16,MI,58023,353156,5357,411179
2020-05-17,MI,58278,363548,5396,421826
2020-05-18,MI,58812,376115,5427,434927
2020-05-19,MI,59576,392208,5470,451784
2020-05-20,MI,60151,405848,5514,465999
2020-05-21,MI,60610,421788,5555,482398
2020-05-22,MI,61075,441282,5586,502357
2020-05-23,MI,61293,455556,5612,516849
2020-05-24,MI,61457,467087,5640,528544
2020-05-25,MI,61632,476325,5678,537957
2020-05-26,MI,62075,487906,5703,549981
2020-05-27,MI,62461,505609,5727,568070
2020-05-28,MI,62797,522663,5751,585460
2020-05-29,MI,63116,538868,5778,601984
2020-05-30,MI,63321,554509,5802,617830
2020-05-31,MI,63568,567192,5818,630760
2020-06-01,MI,63813,581424,5843,645237
2020-06-02,MI,64103,597072,5869,661175
2020-06-03,MI,64382,613173,5884,677555
2020-06-04,MI,64616,627907,5901,692523
2020-06-05,MI,64821,640450,5909,705271
2020-06-06,MI,64914,650942,5916,715856
2020-06-07,MI,64969,661256,5927,726225
2020-06-08,MI,65104,674060,5942,739164
2020-06-09,MI,65167,690869,5951,756036
2020-06-10,MI,65182,690869,5952,756051
2020-06-11,MI,65449,705071,5985,770520
2020-06-12,MI,65672,720615,5990,786287
2020-06-13,MI,65836,733647,6013,799483
2020-06-14,MI,66054,747444,6016,813498
2020-06-15,MI,66085,757952,6017,824037
2020-06-16,MI,66269,769265,6034,835534
2020-06-17,MI,66497,783388,6036,849885
2020-06-18,MI,66798,783388,6061,850186
2020-06-19,MI,67097,812831,6067,879928
2020-06-20,MI,67545,827089,6087,894634
2020-06-21,MI,67711,839715,6090,907426
2020-06-22,MI,67957,850060,6097,918017
2020-06-23,MI,68197,860471,6109,928668
2020-06-24,MI,68555,876250,6114,944805
2020-06-25,MI,68989,893850,6133,962839
2020-06-26,MI,69329,912377,6134,981706
2020-06-27,MI,69679,931142,6153,1000821
2020-06-28,MI,69946,946733,6158,1016679
2020-06-29,MI,70223,959152,6161,1029375
2020-06-30,MI,70728,974329,6193,1045057
2020-07-01,MI,71089,990770,6198,1061859
2020-07-02,MI,71678,1013459,6212,1085137
2020-07-03,MI,72175,1036090,6215,1108265
2020-07-04,MI,72581,1057573,6218,1130154
2020-07-05,MI,72941,1073878,6218,1146819
2020-07-06,MI,73269,1086094,6221,1159363
2020-07-07,MI,73900,1102611,6251,1176511
2020-07-08,MI,74551,1125452,6262,1200003
2020-07-09,MI,75063,1148490,6271,1223553
2020-07-10,MI,75685,1171120,6285,1246805
2020-07-11,MI,76370,1197752,6313,1274122
2020-07-12,MI,76776,1219379,6314,1296155
2020-07-13,MI,77198,1236229,6321,1313427
2020-07-14,MI,77864,1255922,6326,1333786
2020-07-15,MI,78913,1289006,6330,1367919
2020-07-16,MI,79839,1315315,6348,1395154
2020-07-17,MI,80593,1344913,6355,1425506
2020-07-18,MI,81338,1374740,6364,1456078
2020-07-19,MI,81868,1402591,6366,1484459
2020-07-20,MI,82395,1424394,6373,1506789
2020-07-21,MI,83059,1446316,6382,1529375
2020-07-22,MI,83730,1475883,6388,1559613
2020-07-23,MI,84431,1502293,6395,1586724
2020-03-06,MN,1,36,0,37
2020-03-07,MN,2,48,0,50
2020-03-08,MN,2,48,0,50
2020-03-09,MN,5,80,0,85
2020-03-10,MN,11,132,0,143
2020-03-11,MN,21,217,0,238
2020-03-12,MN,43,307,0,350
2020-03-13,MN,62,541,0,603
2020-03-14,MN,90,847,0,937
2020-03-15,MN,128,1387,0,1515
2020-03-16,MN,179,1839,0,2018
2020-03-17,MN,246,2276,0,2522
2020-03-18,MN,269,2685,0,2954
2020-03-19,MN,287,2949,0,3236
2020-03-20,MN,303,3741,0,4044
2020-03-21,MN,327,3952,1,4279
2020-03-22,MN,349,4511,1,4860
2020-03-23,MN,393,4511,1,4904
2020-03-24,MN,444,5550,1,5994
2020-03-25,MN,502,11188,1,11690
2020-03-26,MN,565,12604,2,13169
2020-03-27,MN,640,13605,4,14245
2020-03-28,MN,687,17395,5,18082
2020-03-29,MN,725,18566,9,19291
2020-03-30,MN,823,19512,10,20335
2020-03-31,MN,916,20935,12,21851
2020-04-01,MN,973,21880,17,22853
2020-04-02,MN,1056,23780,18,24836
2020-04-03,MN,1119,25063,22,26182
2020-04-04,MN,1158,26687,24,27845
2020-04-05,MN,1217,28090,29,29307
2020-04-06,MN,1330,29155,30,30485
2020-04-07,MN,1432,30603,34,32035
2020-04-08,MN,1534,31954,39,33488
2020-04-09,MN,1637,33682,50,35319
2020-04-10,MN,1732,35346,57,37078
2020-04-11,MN,1806,36898,64,38704
2020-04-12,MN,1864,38030,70,39894
2020-04-13,MN,2012,38667,70,40679
2020-04-14,MN,2165,39705,79,41870
2020-04-15,MN,2321,41245,87,43566
2020-04-16,MN,2486,42536,94,45022
2020-04-17,MN,2668,43820,111,46488
2020-04-18,MN,2788,45182,121,47970
2020-04-19,MN,2914,46288,134,49202
2020-04-20,MN,3190,46854,143,50044
2020-04-21,MN,3452,48341,160,51793
2020-04-22,MN,3758,50165,179,53923
2020-04-23,MN,4270,52144,200,56414
2020-04-24,MN,4788,54706,221,59494
2020-04-25,MN,5127,56982,244,62109
2020-04-26,MN,5512,59161,272,64673
2020-04-27,MN,6187,60503,286,66690
2020-04-28,MN,6788,63248,301,70036
2020-04-29,MN,7468,69650,319,77118
2020-04-30,MN,8116,73349,343,81465
2020-05-01,MN,8736,77214,371,85950
2020-05-02,MN,9071,80609,395,89680
2020-05-03,MN,9411,83433,419,92844
2020-05-04,MN,10235,86677,428,96912
2020-05-05,MN,10876,89202,455,100078
2020-05-06,MN,11510,93047,485,104557
2020-05-07,MN,12328,97244,508,109572
2020-05-08,MN,13040,101408,534,114448
2020-05-09,MN,13321,106040,558,119361
2020-05-10,MN,13552,111109,578,124661
2020-05-11,MN,14379,115585,591,129964
2020-05-12,MN,15043,118934,614,133977
2020-05-13,MN,15772,125502,638,141274
2020-05-14,MN,16565,131443,663,148008
2020-05-15,MN,17363,139773,692,157136
2020-05-16,MN,17705,147399,709,165104
2020-05-17,MN,18016,153069,731,171085
2020-05-18,MN,18987,158487,740,177474
2020-05-19,MN,19842,164009,757,183851
2020-05-20,MN,20609,170199,786,190808
2020-05-21,MN,21582,177506,818,199088
2020-05-22,MN,22374,186436,851,208810
2020-05-23,MN,22765,194941,861,217706
2020-05-24,MN,23121,201566,878,224687
2020-05-25,MN,23524,207816,890,231340
2020-05-26,MN,24308,213974,908,238282
2020-05-27,MN,24988,222821,942,247809
2020-05-28,MN,25559,232195,977,257754
2020-05-29,MN,26013,242124,1006,268137
2020-05-30,MN,26181,250392,1036,276573
2020-05-31,MN,26322,257133,1050,283455
2020-06-01,MN,26897,260739,1060,287636
2020-06-02,MN,27376,267931,1082,295307
2020-06-03,MN,27889,283319,1097,311208
2020-06-04,MN,28290,293858,1126,322148
2020-06-05,MN,28688,304497,1159,333185
2020-06-06,MN,28853,314744,1181,343597
2020-06-07,MN,28988,324153,1197,353141
2020-06-08,MN,29436,331476,1208,360912
2020-06-09,MN,29866,339927,1228,369793
2020-06-10,MN,30199,351634,1267,381833
2020-06-11,MN,30418,364816,1280,395234
2020-06-12,MN,30463,377589,1305,408052
2020-06-13,MN,30465,387245,1314,417710
2020-06-14,MN,30471,387239,1329,417710
2020-06-15,MN,30693,392229,1335,422922
2020-06-16,MN,30882,398263,1344,429145
2020-06-17,MN,31296,417291,1357,448587
2020-06-18,MN,31675,429204,1376,460879
2020-06-19,MN,32031,443121,1393,475152
2020-06-20,MN,32467,459576,1404,492043
2020-06-21,MN,32920,471443,1412,504363
2020-06-22,MN,33227,479910,1416,513137
2020-06-23,MN,33469,486576,1425,520045
2020-06-24,MN,33763,495880,1432,529643
2020-06-25,MN,34123,508573,1441,542696
2020-06-26,MN,34616,522662,1446,557278
2020-06-27,MN,35033,533874,1452,568907
2020-06-28,MN,35549,549868,1460,585417
2020-06-29,MN,35861,557094,1470,592955
2020-06-30,MN,36303,569013,1476,605316
2020-07-01,MN,36716,580391,1482,617107
2020-07-02,MN,37210,593217,1495,630427
2020-07-03,MN,37624,607548,1503,645172
2020-07-04,MN,37624,607548,1503,645172
2020-07-05,MN,38136,635879,1508,674015
2020-07-06,MN,38569,641124,1511,679693
2020-07-07,MN,39133,646114,1514,685247
2020-07-08,MN,39589,653381,1523,692970
2020-07-09,MN,40163,665277,1528,705440
2020-07-10,MN,40767,685058,1533,725825
2020-07-11,MN,41571,700524,1537,742095
2020-07-12,MN,42281,712771,1540,755052
2020-07-13,MN,42772,726217,1542,768989
2020-07-14,MN,43170,734444,1548,777614
2020-07-15,MN,43742,746755,1558,790497
2020-07-16,MN,44347,760865,1566,805212
2020-07-17,MN,45013,774498,1573,819511
2020-07-18,MN,45470,790492,1578,835962
2020-07-19,MN,46204,806984,1581,853188
2020-07-20,MN,47107,820303,1585,867410
2020-07-21,MN,47457,829402,1588,876859
2020-07-22,MN,47961,840590,1592,888551
2020-07-23,MN,48721,856594,1601,905315
2020-03-07,MO,0,0,0,0
2020-03-08,MO,1,0,0,1
2020-03-09,MO,1,0,0,1
2020-03-10,MO,1,0,0,1
2020-03-11,MO,1,0,0,1
2020-03-12,MO,1,64,0,65
2020-03-13,MO,2,71,0,73
2020-03-14,MO,4,90,0,94
2020-03-15,MO,5,122,0,127
2020-03-16,MO,6,164,0,170
2020-03-17,MO,8,207,0,215
2020-03-18,MO,13,253,0,266
2020-03-19,MO,24,308,1,332
2020-03-20,MO,47,369,1,416
2020-03-21,MO,73,369,3,442
2020-03-22,MO,90,369,3,459
2020-03-23,MO,183,369,3,552
2020-03-24,MO,183,369,3,552
2020-03-25,MO,356,369,8,725
2020-03-26,MO,502,369,8,871
2020-03-27,MO,669,369,8,1038
2020-03-28,MO,838,10082,10,10920
2020-03-29,MO,838,11547,10,12385
2020-03-30,MO,1031,13204,13,14235
2020-03-31,MO,1327,14614,14,15941
2020-04-01,MO,1581,15846,18,17427
2020-04-02,MO,1834,17849,19,19683
2020-04-03,MO,2113,19357,19,21470
2020-04-04,MO,2291,22614,24,24905
2020-04-05,MO,2367,24882,34,27249
2020-04-06,MO,2722,27113,39,29835
2020-04-07,MO,3037,28932,53,31969
2020-04-08,MO,3327,30783,58,34110
2020-04-09,MO,3539,34955,77,38494
2020-04-10,MO,3799,36941,96,40740
2020-04-11,MO,4024,39148,109,43172
2020-04-12,MO,4160,41040,110,45200
2020-04-13,MO,4388,41040,114,45428
2020-04-14,MO,4686,43292,133,47978
2020-04-15,MO,4895,44117,147,49012
2020-04-16,MO,5111,45537,152,50648
2020-04-17,MO,5283,46434,165,51717
2020-04-18,MO,5517,48242,175,53759
2020-04-19,MO,5667,48242,176,53909
2020-04-20,MO,5807,50206,177,56013
2020-04-21,MO,5941,51179,189,57120
2020-04-22,MO,6137,52019,208,58156
2020-04-23,MO,6321,53129,218,59450
2020-04-24,MO,6625,58582,262,65207
2020-04-25,MO,6826,60392,273,67218
2020-04-26,MO,6997,62751,274,69748
2020-04-27,MO,7171,63935,288,71106
2020-04-28,MO,7303,66200,314,73503
2020-04-29,MO,7425,69734,318,77159
2020-04-30,MO,7562,73125,329,80687
2020-05-01,MO,7835,74590,337,82425
2020-05-02,MO,8154,74590,351,82744
2020-05-03,MO,8386,74590,352,82976
2020-05-04,MO,8754,82697,358,91451
2020-05-05,MO,8916,86150,377,95066
2020-05-06,MO,9102,91645,396,100747
2020-05-07,MO,9341,94281,418,103622
2020-05-08,MO,9489,99232,449,108721
2020-05-09,MO,9666,99232,472,108898
2020-05-10,MO,9844,105702,482,115546
2020-05-11,MO,9918,105702,488,115620
2020-05-12,MO,10006,111290,524,121296
2020-05-13,MO,10142,114000,542,124142
2020-05-14,MO,10317,116793,562,127110
2020-05-15,MO,10456,124002,576,134458
2020-05-16,MO,10675,128665,589,139340
2020-05-17,MO,10789,135466,594,146255
2020-05-18,MO,10945,140393,605,151338
2020-05-19,MO,11080,143030,616,154110
2020-05-20,MO,11232,150752,631,161984
2020-05-21,MO,11340,150752,661,162092
2020-05-22,MO,11558,161388,671,172946
2020-05-23,MO,11752,136552,676,148304
2020-05-24,MO,11988,139631,681,151619
2020-05-25,MO,12167,145218,685,157385
2020-05-26,MO,12291,148007,686,160298
2020-05-27,MO,12492,153029,696,165521
2020-05-28,MO,12673,158394,707,171067
2020-05-29,MO,12795,165055,738,177850
2020-05-30,MO,12962,172468,771,185430
2020-05-31,MO,13147,180414,772,193561
2020-06-01,MO,13327,186381,773,199708
2020-06-02,MO,13575,191855,783,205430
2020-06-03,MO,13767,197586,786,211353
2020-06-04,MO,14057,204604,786,218661
2020-06-05,MO,14253,210289,799,224542
2020-06-06,MO,14442,215623,809,230065
2020-06-07,MO,14553,222305,809,236858
2020-06-08,MO,14734,226727,819,241461
2020-06-09,MO,14913,230782,840,245695
2020-06-10,MO,15187,236442,848,251629
2020-06-11,MO,15390,243650,860,259040
2020-06-12,MO,15585,249550,872,265135
2020-06-13,MO,15810,253986,879,269796
2020-06-14,MO,15810,259679,879,275489
2020-06-15,MO,16189,263752,880,279941
2020-06-16,MO,16414,268377,882,284791
2020-06-17,MO,16625,268377,909,285002
2020-06-18,MO,16908,280434,946,297342
2020-06-19,MO,17201,289083,948,306284
2020-06-20,MO,17590,293525,955,311115
2020-06-21,MO,18003,297154,956,315157
2020-06-22,MO,18143,299231,961,317374
2020-06-23,MO,18143,299231,961,317374
2020-06-24,MO,18868,308156,975,327024
2020-06-25,MO,19421,322227,982,341648
2020-06-26,MO,19914,328704,990,348618
2020-06-27,MO,20261,335029,996,355290
2020-06-28,MO,20575,340598,997,361173
2020-06-29,MO,21043,346363,998,367406
2020-06-30,MO,21551,351456,1015,373007
2020-07-01,MO,21927,367813,1017,389740
2020-07-02,MO,22283,375035,1022,397318
2020-07-03,MO,22830,382129,1026,404959
2020-07-04,MO,23215,389046,1027,412261
2020-07-05,MO,23436,396073,1028,419509
2020-07-06,MO,23856,402889,1028,426745
2020-07-07,MO,24629,410719,1042,435348
2020-07-08,MO,25204,417136,1046,442340
2020-07-09,MO,25999,428826,1051,454825
2020-07-10,MO,25999,428826,1051,454825
2020-07-11,MO,27133,447417,1069,474550
2020-07-12,MO,27443,458065,1069,485508
2020-07-13,MO,27890,467887,1083,495777
2020-07-14,MO,28826,476277,1093,505103
2020-07-15,MO,29714,488233,1102,517947
2020-07-16,MO,30422,498879,1113,529301
2020-07-17,MO,31288,506608,1121,537896
2020-07-18,MO,32248,518628,1130,550876
2020-07-19,MO,33094,525985,1129,559079
2020-07-20,MO,33624,538288,1132,571912
2020-07-21,MO,34762,545558,1143,580320
2020-07-22,MO,36063,553397,1159,589460
2020-07-23,MO,37700,565584,1179,603284
2020-03-16,MP,0,0,0,0
2020-03-17,MP,0,0,0,0
2020-03-18,MP,0,0,0,0
2020-03-19,MP,0,0,0,0
2020-03-20,MP,0,0,0,0
2020-03-21,MP,0,0,0,0
2020-03-22,MP,0,0,0,0
2020-03-23,MP,0,0,0,0
2020-03-24,MP,0,0,0,0
2020-03-25,MP,0,0,0,0
2020-03-26,MP,0,0,0,0
2020-03-27,MP,0,0,0,0
2020-03-28,MP,2,0,0,2
2020-03-29,MP,2,0,0,2
2020-03-30,MP,2,0,0,2
2020-03-31,MP,2,0,0,2
2020-04-01,MP,6,0,0,6
2020-04-02,MP,8,13,1,21
2020-04-03,MP,8,13,1,21
2020-04-04,MP,8,13,1,21
2020-04-05,MP,8,13,1,21
2020-04-06,MP,8,13,1,21
2020-04-07,MP,8,15,2,23
2020-04-08,MP,11,27,2,38
2020-04-09,MP,11,27,2,38
2020-04-10,MP,11,27,2,38
2020-04-11,MP,11,27,2,38
2020-04-12,MP,11,27,2,38
2020-04-13,MP,11,27,2,38
2020-04-14,MP,13,27,2,40
2020-04-15,MP,13,27,2,40
2020-04-16,MP,13,27,2,40
2020-04-17,MP,13,42,2,55
2020-04-18,MP,14,42,2,56
2020-04-19,MP,14,42,2,56
2020-04-20,MP,14,51,2,65
2020-04-21,MP,14,51,2,65
2020-04-22,MP,14,51,2,65
2020-04-23,MP,14,51,2,65
2020-04-24,MP,14,51,2,65
2020-04-25,MP,14,51,2,65
2020-04-26,MP,14,51,2,65
2020-04-27,MP,14,51,2,65
2020-04-28,MP,14,51,2,65
2020-04-29,MP,14,210,2,224
2020-04-30,MP,14,585,2,599
2020-05-01,MP,14,749,2,763
2020-05-02,MP,14,934,2,948
2020-05-03,MP,14,1321,2,1335
2020-05-04,MP,14,1321,2,1335
2020-05-05,MP,14,1783,2,1797
2020-05-06,MP,15,1783,2,1798
2020-05-07,MP,15,1783,2,1798
2020-05-08,MP,15,2321,2,2336
2020-05-09,MP,16,2321,2,2337
2020-05-10,MP,16,2321,2,2337
2020-05-11,MP,19,2676,2,2695
2020-05-12,MP,19,2854,2,2873
2020-05-13,MP,19,3021,2,3040
2020-05-14,MP,19,3306,2,3325
2020-05-15,MP,19,3306,2,3325
2020-05-16,MP,21,3318,2,3339
2020-05-17,MP,21,3318,2,3339
2020-05-18,MP,21,3399,2,3420
2020-05-19,MP,21,3796,2,3817
2020-05-20,MP,21,3796,2,3817
2020-05-21,MP,22,4067,2,4089
2020-05-22,MP,22,4296,2,4318
2020-05-23,MP,22,4296,2,4318
2020-05-24,MP,22,4735,2,4757
2020-05-25,MP,22,4735,2,4757
2020-05-26,MP,22,4918,2,4940
2020-05-27,MP,22,5178,2,5200
2020-05-28,MP,22,5401,2,5423
2020-05-29,MP,22,5662,2,5684
2020-05-30,MP,22,5986,2,6008
2020-05-31,MP,22,6151,2,6173
2020-06-01,MP,22,6312,2,6334
2020-06-02,MP,23,6534,2,6557
2020-06-03,MP,23,6534,2,6557
2020-06-04,MP,26,6669,2,6695
2020-06-05,MP,26,6669,2,6695
2020-06-06,MP,26,6669,2,6695
2020-06-07,MP,27,7214,2,7241
2020-06-08,MP,28,7214,2,7242
2020-06-09,MP,30,7493,2,7523
2020-06-10,MP,30,7493,2,7523
2020-06-11,MP,30,7551,2,7581
2020-06-12,MP,30,7732,2,7762
2020-06-13,MP,30,7906,2,7936
2020-06-14,MP,30,8139,2,8169
2020-06-15,MP,30,8139,2,8169
2020-06-16,MP,30,8139,2,8169
2020-06-17,MP,30,8139,2,8169
2020-06-18,MP,30,8139,2,8169
2020-06-19,MP,30,8139,2,8169
2020-06-20,MP,30,8139,2,8169
2020-06-21,MP,30,8139,2,8169
2020-06-22,MP,30,8139,2,8169
2020-06-23,MP,30,8187,2,8217
2020-06-24,MP,30,8187,2,8217
2020-06-25,MP,30,8187,2,8217
2020-06-26,MP,30,8187,2,8217
2020-06-27,MP,30,8187,2,8217
2020-06-28,MP,30,8187,2,8217
2020-06-29,MP,30,8187,2,8217
2020-06-30,MP,30,8187,2,8217
2020-07-01,MP,30,8187,2,8217
2020-07-02,MP,30,8187,2,8217
2020-07-03,MP,31,8187,2,8218
2020-07-04,MP,31,8187,2,8218
2020-07-05,MP,31,8187,2,8218
2020-07-06,MP,31,8187,2,8218
2020-07-07,MP,31,8187,2,8218
2020-07-08,MP,31,10734,2,10765
2020-07-09,MP,31,10734,2,10765
2020-07-10,MP,31,10734,2,10765
2020-07-11,MP,31,10734,2,10765
2020-07-12,MP,33,10734,2,10767
2020-07-13,MP,33,10734,2,10767
2020-07-14,MP,33,10664,2,10697
2020-07-15,MP,36,10664,2,10700
2020-07-16,MP,36,10664,2,10700
2020-07-17,MP,37,10664,2,10701
2020-07-18,MP,37,10664,2,10701
2020-07-19,MP,37,10664,2,10701
2020-07-20,MP,37,11055,2,11092
2020-07-21,MP,38,11055,2,11093
2020-07-22,MP,38,12707,2,12745
2020-07-23,MP,38,11300,2,11338
2020-03-07,MS,0,0,0,0
2020-03-08,MS,0,0,0,0
2020-03-09,MS,0,0,0,0
2020-03-10,MS,0,0,0,0
2020-03-11,MS,0,20,0,20
2020-03-12,MS,1,41,0,42
2020-03-13,MS,4,41,0,45
2020-03-14,MS,6,84,0,90
2020-03-15,MS,10,84,0,94
2020-03-16,MS,12,277,0,289
2020-03-17,MS,21,368,0,389
2020-03-18,MS,34,479,0,513
2020-03-19,MS,50,552,0,602
2020-03-20,MS,80,695,1,775
2020-03-21,MS,140,695,1,835
2020-03-22,MS,207,1114,1,1321
2020-03-23,MS,249,1143,1,1392
2020-03-24,MS,320,1552,1,1872
2020-03-25,MS,377,1566,2,1943
2020-03-26,MS,485,2291,6,2776
2020-03-27,MS,579,2560,8,3139
2020-03-28,MS,663,2560,13,3223
2020-03-29,MS,758,2560,14,3318
2020-03-30,MS,847,2989,16,3836
2020-03-31,MS,937,3537,20,4474
2020-04-01,MS,1073,3712,22,4785
2020-04-02,MS,1177,4753,26,5930
2020-04-03,MS,1358,4753,29,6111
2020-04-04,MS,1455,5133,35,6588
2020-04-05,MS,1638,5580,43,7218
2020-04-06,MS,1738,18632,51,20370
2020-04-07,MS,1915,18632,59,20547
2020-04-08,MS,2003,18632,67,20635
2020-04-09,MS,2260,18632,76,20892
2020-04-10,MS,2469,18632,82,21101
2020-04-11,MS,2642,18632,93,21274
2020-04-12,MS,2781,18632,96,21413
2020-04-13,MS,2942,28042,98,30984
2020-04-14,MS,3087,34791,111,37878
2020-04-15,MS,3360,34791,122,38151
2020-04-16,MS,3624,34791,129,38415
2020-04-17,MS,3793,34791,140,38584
2020-04-18,MS,3974,34791,152,38765
2020-04-19,MS,4274,34791,159,39065
2020-04-20,MS,4512,46922,169,51434
2020-04-21,MS,4716,47648,183,52364
2020-04-22,MS,4894,48941,193,53835
2020-04-23,MS,5153,50236,201,55389
2020-04-24,MS,5434,50236,209,55670
2020-04-25,MS,5718,53239,221,58957
2020-04-26,MS,5911,54877,227,60788
2020-04-27,MS,6094,57368,229,63462
2020-04-28,MS,6342,58070,239,64412
2020-04-29,MS,6569,59525,250,66094
2020-04-30,MS,6815,59525,261,66340
2020-05-01,MS,7212,64336,281,71548
2020-05-02,MS,7441,67034,291,74475
2020-05-03,MS,7550,70043,303,77593
2020-05-04,MS,7877,71800,310,79677
2020-05-05,MS,8207,72101,342,80308
2020-05-06,MS,8424,72101,374,80525
2020-05-07,MS,8686,72101,396,80787
2020-05-08,MS,9090,72101,409,81191
2020-05-09,MS,9378,72101,421,81479
2020-05-10,MS,9501,72101,430,81602
2020-05-11,MS,9674,86211,435,95885
2020-05-12,MS,9908,87784,457,97692
2020-05-13,MS,10090,89958,465,100048
2020-05-14,MS,10483,94843,480,105326
2020-05-15,MS,10801,96022,493,106823
2020-05-16,MS,11123,97353,510,108476
2020-05-17,MS,11296,101830,521,113126
2020-05-18,MS,11432,104335,528,115767
2020-05-19,MS,11704,106056,554,117760
2020-05-20,MS,11967,108713,570,120680
2020-05-21,MS,12222,113748,580,125970
2020-05-22,MS,12624,125349,596,137973
2020-05-23,MS,13005,121215,616,134220
2020-05-24,MS,13252,124650,625,137902
2020-05-25,MS,13458,130459,635,143917
2020-05-26,MS,13731,134088,652,147819
2020-05-27,MS,14044,134088,670,148132
2020-05-28,MS,14372,142125,693,156497
2020-05-29,MS,14790,151518,710,166308
2020-05-30,MS,15229,150703,723,165932
2020-05-31,MS,15501,156336,734,171837
2020-06-01,MS,15752,160502,739,176254
2020-06-02,MS,16020,163478,767,179498
2020-06-03,MS,16322,168425,782,184747
2020-06-04,MS,16560,168425,794,184985
2020-06-05,MS,16759,176354,803,193113
2020-06-06,MS,16769,176354,803,193123
2020-06-07,MS,17270,185979,817,203249
2020-06-08,MS,17768,190444,837,208212
2020-06-09,MS,17768,190444,837,208212
2020-06-10,MS,18483,195402,868,213885
2020-06-11,MS,18483,195402,868,213885
2020-06-12,MS,19091,195402,881,214493
2020-06-13,MS,19348,194537,889,213885
2020-06-14,MS,19516,194537,891,214053
2020-06-15,MS,19799,210704,895,230503
2020-06-16,MS,20152,220651,915,240803
2020-06-17,MS,20641,223748,938,244389
2020-06-18,MS,20641,218074,938,238715
2020-06-19,MS,20641,218074,938,238715
2020-06-20,MS,20641,218074,938,238715
2020-06-21,MS,20641,218074,938,238715
2020-06-22,MS,22287,230962,978,253249
2020-06-23,MS,22898,230962,989,253860
2020-06-24,MS,23424,238237,1011,261661
2020-06-25,MS,24516,241481,1016,265997
2020-06-26,MS,25066,246828,1022,271894
2020-06-27,MS,25531,251790,1035,277321
2020-06-28,MS,25892,254296,1039,280188
2020-06-29,MS,26567,256955,1059,283522
2020-06-30,MS,27247,260299,1073,287546
2020-07-01,MS,27900,265852,1082,293752
2020-07-02,MS,28770,270269,1092,299039
2020-07-03,MS,28770,270269,1092,299039
2020-07-04,MS,30674,279241,1107,309915
2020-07-05,MS,30900,279241,1111,310141
2020-07-06,MS,31257,283431,1114,314688
2020-07-07,MS,32214,283431,1158,315645
2020-07-08,MS,32888,283431,1188,316319
2020-07-09,MS,33591,291213,1204,324804
2020-07-10,MS,34622,295690,1215,330312
2020-07-11,MS,35419,298924,1230,334343
2020-07-12,MS,36287,298924,1249,335211
2020-07-13,MS,36680,306735,1250,343415
2020-07-14,MS,37542,312671,1272,350213
2020-07-15,MS,38567,318290,1290,356857
2020-07-16,MS,39797,324103,1308,363900
2020-07-17,MS,40829,330635,1332,371464
2020-07-18,MS,41846,335439,1346,377285
2020-07-19,MS,42638,335439,1355,378077
2020-07-20,MS,43889,346086,1358,389975
2020-07-21,MS,45524,349674,1389,395198
2020-07-22,MS,47071,355959,1423,403030
2020-07-23,MS,48053,355959,1436,404012
2020-03-07,MT,0,11,0,11
2020-03-08,MT,0,11,0,11
2020-03-09,MT,0,11,0,11
2020-03-10,MT,0,15,0,15
2020-03-11,MT,0,21,0,21
2020-03-12,MT,1,34,0,35
2020-03-13,MT,1,55,0,56
2020-03-14,MT,5,103,0,108
2020-03-15,MT,7,103,0,110
2020-03-16,MT,7,198,0,205
2020-03-17,MT,8,303,0,311
2020-03-18,MT,10,499,0,509
2020-03-19,MT,12,761,0,773
2020-03-20,MT,16,931,0,947
2020-03-21,MT,20,1146,0,1166
2020-03-22,MT,31,1146,0,1177
2020-03-23,MT,34,1146,0,1180
2020-03-24,MT,46,1643,0,1689
2020-03-25,MT,53,1948,0,2001
2020-03-26,MT,71,2128,0,2199
2020-03-27,MT,108,2590,0,2698
2020-03-28,MT,129,3256,1,3385
2020-03-29,MT,154,4143,1,4297
2020-03-30,MT,171,4143,4,4314
2020-03-31,MT,184,4234,4,4418
2020-04-01,MT,208,4710,5,4918
2020-04-02,MT,227,5093,5,5320
2020-04-03,MT,243,5333,5,5576
2020-04-04,MT,265,5912,5,6177
2020-04-05,MT,286,6317,6,6603
2020-04-06,MT,299,6491,6,6790
2020-04-07,MT,319,6666,6,6985
2020-04-08,MT,332,7066,6,7398
2020-04-09,MT,354,7506,6,7860
2020-04-10,MT,365,7932,6,8297
2020-04-11,MT,377,8204,6,8581
2020-04-12,MT,387,8526,6,8913
2020-04-13,MT,394,8704,7,9098
2020-04-14,MT,399,8835,7,9234
2020-04-15,MT,404,9179,7,9583
2020-04-16,MT,415,9521,7,9936
2020-04-17,MT,422,9822,8,10244
2020-04-18,MT,426,10143,10,10569
2020-04-19,MT,433,10465,10,10898
2020-04-20,MT,433,10618,10,11051
2020-04-21,MT,437,10804,12,11241
2020-04-22,MT,439,11144,14,11583
2020-04-23,MT,442,11433,14,11875
2020-04-24,MT,444,11683,14,12127
2020-04-25,MT,445,12052,14,12497
2020-04-26,MT,448,12414,14,12862
2020-04-27,MT,449,12584,14,13033
2020-04-28,MT,451,12740,15,13191
2020-04-29,MT,451,13077,16,13528
2020-04-30,MT,453,13461,16,13914
2020-05-01,MT,453,13750,16,14203
2020-05-02,MT,455,14180,16,14635
2020-05-03,MT,455,14552,16,15007
2020-05-04,MT,457,14631,16,15088
2020-05-05,MT,456,14816,16,15272
2020-05-06,MT,456,19248,16,19704
2020-05-07,MT,456,19791,16,20247
2020-05-08,MT,458,20487,16,20945
2020-05-09,MT,458,20871,16,21329
2020-05-10,MT,458,21246,16,21704
2020-05-11,MT,459,22113,16,22572
2020-05-12,MT,461,22574,16,23035
2020-05-13,MT,462,23390,16,23852
2020-05-14,MT,462,24087,16,24549
2020-05-15,MT,466,24952,16,25418
2020-05-16,MT,468,25623,16,26091
2020-05-17,MT,468,26417,16,26885
2020-05-18,MT,470,27697,16,28167
2020-05-19,MT,471,28479,16,28950
2020-05-20,MT,478,29248,16,29726
2020-05-21,MT,479,30045,16,30524
2020-05-22,MT,479,31378,16,31857
2020-05-23,MT,479,32173,16,32652
2020-05-24,MT,479,32902,16,33381
2020-05-25,MT,479,33203,16,33682
2020-05-26,MT,479,33355,17,33834
2020-05-27,MT,481,35162,17,35643
2020-05-28,MT,485,36308,17,36793
2020-05-29,MT,493,38036,17,38529
2020-05-30,MT,505,38779,17,39284
2020-05-31,MT,515,39283,17,39798
2020-06-01,MT,519,40138,17,40657
2020-06-02,MT,523,41689,17,42212
2020-06-03,MT,525,42923,17,43448
2020-06-04,MT,539,44103,17,44642
2020-06-05,MT,541,45347,18,45888
2020-06-06,MT,540,46214,18,46754
2020-06-07,MT,545,46833,18,47378
2020-06-08,MT,548,51044,18,51592
2020-06-09,MT,554,52630,18,53184
2020-06-10,MT,561,54055,18,54616
2020-06-11,MT,563,55214,18,55777
2020-06-12,MT,573,56449,18,57022
2020-06-13,MT,588,57416,18,58004
2020-06-14,MT,601,58306,19,58907
2020-06-15,MT,609,60328,19,60937
2020-06-16,MT,614,62963,19,63577
2020-06-17,MT,630,64885,20,65515
2020-06-18,MT,655,66215,20,66870
2020-06-19,MT,666,67756,20,68422
2020-06-20,MT,698,68832,20,69530
2020-06-21,MT,717,69640,20,70357
2020-06-22,MT,740,70565,21,71305
2020-06-23,MT,743,73180,21,73923
2020-06-24,MT,766,74300,21,75066
2020-06-25,MT,803,77529,21,78332
2020-06-26,MT,829,79332,22,80161
2020-06-27,MT,852,80395,22,81247
2020-06-28,MT,863,81611,22,82474
2020-06-29,MT,919,87824,22,88743
2020-06-30,MT,967,89894,22,90861
2020-07-01,MT,1016,92314,22,93330
2020-07-02,MT,1083,94066,22,95149
2020-07-03,MT,1128,96375,23,97503
2020-07-04,MT,1167,97783,23,98950
2020-07-05,MT,1212,98894,23,100106
2020-07-06,MT,1249,101677,23,102926
2020-07-07,MT,1327,104000,23,105327
2020-07-08,MT,1371,105050,23,106421
2020-07-09,MT,1466,107299,25,108765
2020-07-10,MT,1593,110585,28,112178
2020-07-11,MT,1677,111682,29,113359
2020-07-12,MT,1758,112903,29,114661
2020-07-13,MT,1843,116852,32,118695
2020-07-14,MT,1952,119444,34,121396
2020-07-15,MT,2096,121662,34,123758
2020-07-16,MT,2231,125609,35,127840
2020-07-17,MT,2366,128038,37,130404
2020-07-18,MT,2471,129408,37,131879
2020-07-19,MT,2533,130626,37,133159
2020-07-20,MT,2621,136421,39,139042
2020-07-21,MT,2712,138290,40,141002
2020-07-22,MT,2813,140705,42,143518
2020-07-23,MT,2910,143308,43,146218
2020-03-04,NC,1,0,0,1
2020-03-05,NC,1,0,0,1
2020-03-06,NC,2,0,0,2
2020-03-07,NC,2,0,0,2
2020-03-08,NC,2,0,0,2
2020-03-09,NC,2,0,0,2
2020-03-10,NC,7,0,0,7
2020-03-11,NC,7,0,0,7
2020-03-12,NC,12,60,0,72
2020-03-13,NC,15,86,0,101
2020-03-14,NC,23,137,0,160
2020-03-15,NC,32,227,0,259
2020-03-16,NC,33,296,0,329
2020-03-17,NC,40,474,0,514
2020-03-18,NC,63,1787,0,1850
2020-03-19,NC,97,2408,0,2505
2020-03-20,NC,137,3096,0,3233
2020-03-21,NC,184,5092,0,5276
2020-03-22,NC,255,6183,0,6438
2020-03-23,NC,297,8141,0,8438
2020-03-24,NC,398,8141,0,8539
2020-03-25,NC,504,9985,1,10489
2020-03-26,NC,636,12274,2,12910
2020-03-27,NC,763,14373,3,15136
2020-03-28,NC,935,16592,4,17527
2020-03-29,NC,1040,17905,4,18945
2020-03-30,NC,1307,19557,6,20864
2020-03-31,NC,1498,21608,8,23106
2020-04-01,NC,1584,24659,10,26243
2020-04-02,NC,1857,26822,16,28679
2020-04-03,NC,2093,29505,19,31598
2020-04-04,NC,2402,36371,24,38773
2020-04-05,NC,2585,37460,31,40045
2020-04-06,NC,2870,37856,33,40726
2020-04-07,NC,3221,37861,46,41082
2020-04-08,NC,3426,39561,53,42987
2020-04-09,NC,3651,44158,65,47809
2020-04-10,NC,3908,53737,74,57645
2020-04-11,NC,4312,56081,80,60393
2020-04-12,NC,4520,57619,81,62139
2020-04-13,NC,4816,58572,86,63388
2020-04-14,NC,5024,60015,108,65039
2020-04-15,NC,5123,62704,117,67827
2020-04-16,NC,5465,65452,131,70917
2020-04-17,NC,5859,67122,152,72981
2020-04-18,NC,6140,70071,164,76211
2020-04-19,NC,6493,72279,172,78772
2020-04-20,NC,6764,72720,179,79484
2020-04-21,NC,6951,76380,213,83331
2020-04-22,NC,7220,83116,242,90336
2020-04-23,NC,7608,88577,253,96185
2020-04-24,NC,8052,92532,269,100584
2020-04-25,NC,8623,96642,289,105265
2020-04-26,NC,8830,99064,299,107894
2020-04-27,NC,9142,100778,306,109920
2020-04-28,NC,9568,103184,342,112752
2020-04-29,NC,9948,108492,354,118440
2020-04-30,NC,10509,117527,378,128036
2020-05-01,NC,10923,122909,399,133832
2020-05-02,NC,11509,127966,420,139475
2020-05-03,NC,11664,132171,422,143835
2020-05-04,NC,11848,134591,430,146439
2020-05-05,NC,12256,139544,452,151800
2020-05-06,NC,12758,151724,477,164482
2020-05-07,NC,13397,157931,507,171328
2020-05-08,NC,13868,164745,527,178613
2020-05-09,NC,14360,172002,544,186362
2020-05-10,NC,14764,177371,547,192135
2020-05-11,NC,15045,180820,550,195865
2020-05-12,NC,15346,186898,577,202244
2020-05-13,NC,15816,194641,597,210457
2020-05-14,NC,16507,202761,615,219268
2020-05-15,NC,17129,214418,641,231547
2020-05-16,NC,17982,220604,652,238586
2020-05-17,NC,18512,230432,659,248944
2020-05-18,NC,19023,236732,661,255755
2020-05-19,NC,19700,245308,691,265008
2020-05-20,NC,20122,257481,702,277603
2020-05-21,NC,20860,269785,716,290645
2020-05-22,NC,21618,281606,728,303224
2020-05-23,NC,22725,306857,737,329582
2020-05-24,NC,23222,313434,744,336656
2020-05-25,NC,23964,320726,754,344690
2020-05-26,NC,24140,328191,766,352331
2020-05-27,NC,24628,339528,794,364156
2020-05-28,NC,25412,349780,827,375192
2020-05-29,NC,26488,364743,859,391231
2020-05-30,NC,27673,376484,877,404157
2020-05-31,NC,28589,387700,886,416289
2020-06-01,NC,29263,392645,898,421908
2020-06-02,NC,29889,405032,921,434921
2020-06-03,NC,30777,418486,939,449263
2020-06-04,NC,31966,436336,960,468302
2020-06-05,NC,33255,448892,966,482147
2020-06-06,NC,34625,462725,992,497350
2020-06-07,NC,35546,475680,996,511226
2020-06-08,NC,36484,483629,1006,520113
2020-06-09,NC,37160,498551,1029,535711
2020-06-10,NC,38171,515479,1053,553650
2020-06-11,NC,39481,533196,1064,572677
2020-06-12,NC,41249,554448,1092,595697
2020-06-13,NC,42676,569014,1104,611690
2020-06-14,NC,44119,583011,1109,627130
2020-06-15,NC,45102,593377,1118,638479
2020-06-16,NC,45853,605568,1154,651421
2020-06-17,NC,46855,620567,1168,667422
2020-06-18,NC,48188,645490,1175,693678
2020-06-19,NC,49840,662473,1197,712313
2020-06-20,NC,51389,679952,1212,731341
2020-06-21,NC,52801,692974,1220,745775
2020-06-22,NC,53605,703740,1223,757345
2020-06-23,NC,54453,719375,1251,773828
2020-06-24,NC,56174,735111,1266,791285
2020-06-25,NC,57183,754095,1284,811278
2020-06-26,NC,58818,777907,1303,836725
2020-06-27,NC,60537,794594,1312,855131
2020-06-28,NC,62142,809763,1322,871905
2020-06-29,NC,63484,822821,1325,886305
2020-06-30,NC,64670,845363,1343,910033
2020-07-01,NC,66513,875725,1373,942238
2020-07-02,NC,68142,902978,1391,971120
2020-07-03,NC,70241,929052,1392,999293
2020-07-04,NC,71654,946642,1395,1018296
2020-07-05,NC,72983,963855,1396,1036838
2020-07-06,NC,74529,977317,1398,1051846
2020-07-07,NC,75875,995415,1420,1071290
2020-07-08,NC,77310,1019372,1441,1096682
2020-07-09,NC,79349,1042462,1461,1121811
2020-07-10,NC,81331,1069281,1479,1150612
2020-07-11,NC,83793,1092265,1499,1176058
2020-07-12,NC,85701,1113874,1503,1199575
2020-07-13,NC,87528,1132958,1510,1220486
2020-07-14,NC,89484,1165362,1552,1254846
2020-07-15,NC,91266,1193371,1568,1284637
2020-07-16,NC,93426,1219331,1588,1312757
2020-07-17,NC,95477,1248497,1606,1343974
2020-07-18,NC,97958,1281185,1629,1379143
2020-07-19,NC,99778,1295086,1634,1394864
2020-07-20,NC,101046,1322842,1642,1423888
2020-07-21,NC,102861,1356136,1668,1458997
2020-07-22,NC,105001,1386819,1698,1491820
2020-07-23,NC,106893,1416782,1726,1523675
2020-03-07,ND,0,0,0,0
2020-03-08,ND,0,0,0,0
2020-03-09,ND,0,0,0,0
2020-03-10,ND,0,6,0,6
2020-03-11,ND,0,7,0,7
2020-03-12,ND,1,12,0,13
2020-03-13,ND,1,39,0,40
2020-03-14,ND,1,54,0,55
2020-03-15,ND,1,95,0,96
2020-03-16,ND,1,123,0,124
2020-03-17,ND,3,220,0,223
2020-03-18,ND,6,268,0,274
2020-03-19,ND,15,493,0,508
2020-03-20,ND,20,800,0,820
2020-03-21,ND,28,1141,0,1169
2020-03-22,ND,28,1260,0,1288
2020-03-23,ND,30,1353,0,1383
2020-03-24,ND,34,1454,0,1488
2020-03-25,ND,39,1734,0,1773
2020-03-26,ND,52,2039,0,2091
2020-03-27,ND,65,2427,0,2492
2020-03-28,ND,83,2809,1,2892
2020-03-29,ND,98,3355,1,3453
2020-03-30,ND,109,3728,2,3837
2020-03-31,ND,126,4131,3,4257
2020-04-01,ND,142,4351,3,4493
2020-04-02,ND,159,4821,3,4980
2020-04-03,ND,173,5625,3,5798
2020-04-04,ND,186,6021,3,6207
2020-04-05,ND,207,6580,3,6787
2020-04-06,ND,225,6988,3,7213
2020-04-07,ND,237,7466,4,7703
2020-04-08,ND,251,8301,4,8552
2020-04-09,ND,269,8721,5,8990
2020-04-10,ND,278,9330,6,9608
2020-04-11,ND,293,9787,7,10080
2020-04-12,ND,308,10042,8,10350
2020-04-13,ND,331,10450,8,10781
2020-04-14,ND,341,10575,9,10916
2020-04-15,ND,365,10952,9,11317
2020-04-16,ND,393,11311,9,11704
2020-04-17,ND,439,11903,9,12342
2020-04-18,ND,528,12435,9,12963
2020-04-19,ND,585,13045,10,13630
2020-04-20,ND,627,14120,13,14747
2020-04-21,ND,644,14343,13,14987
2020-04-22,ND,679,14910,14,15589
2020-04-23,ND,709,15621,15,16330
2020-04-24,ND,748,16701,15,17449
2020-04-25,ND,803,18547,16,19350
2020-04-26,ND,867,19850,17,20717
2020-04-27,ND,942,21492,19,22434
2020-04-28,ND,991,22732,19,23723
2020-04-29,ND,1033,24503,19,25536
2020-04-30,ND,1067,26393,19,27460
2020-05-01,ND,1107,28418,23,29525
2020-05-02,ND,1153,30394,24,31547
2020-05-03,ND,1191,32162,16,33353
2020-05-04,ND,1225,33529,15,34754
2020-05-05,ND,1266,35155,17,36421
2020-05-06,ND,1323,37309,22,38632
2020-05-07,ND,1371,39496,23,40867
2020-05-08,ND,1425,41076,24,42501
2020-05-09,ND,1464,42469,24,43933
2020-05-10,ND,1491,43378,24,44869
2020-05-11,ND,1518,45496,24,47014
2020-05-12,ND,1571,46261,25,47832
2020-05-13,ND,1647,47298,29,48945
2020-05-14,ND,1647,48599,31,50246
2020-05-15,ND,1761,49954,35,51715
2020-05-16,ND,1848,51639,35,53487
2020-05-17,ND,1900,53321,35,55221
2020-05-18,ND,1931,54630,37,56561
2020-05-19,ND,1994,55737,37,57731
2020-05-20,ND,2095,57105,37,59200
2020-05-21,ND,2229,59050,38,61279
2020-05-22,ND,2317,60513,39,62830
2020-05-23,ND,2365,61783,39,64148
2020-05-24,ND,2418,63070,39,65488
2020-05-25,ND,2457,63893,39,66350
2020-05-26,ND,2422,64432,40,66854
2020-05-27,ND,2439,64901,44,67340
2020-05-28,ND,2481,65773,48,68254
2020-05-29,ND,2520,66933,48,69453
2020-05-30,ND,2554,68427,48,70981
2020-05-31,ND,2577,69463,48,72040
2020-06-01,ND,2625,70676,50,73301
2020-06-02,ND,2646,70998,54,73644
2020-06-03,ND,2679,71823,54,74502
2020-06-04,ND,2706,73038,58,75744
2020-06-05,ND,2745,74111,59,76856
2020-06-06,ND,2816,76064,59,78880
2020-06-07,ND,2861,77072,59,79933
2020-06-08,ND,2880,77300,62,80180
2020-06-09,ND,2901,77765,65,80666
2020-06-10,ND,2941,78719,67,81660
2020-06-11,ND,2980,79808,67,82788
2020-06-12,ND,3016,81148,67,84164
2020-06-13,ND,3058,82815,67,85873
2020-06-14,ND,3080,83800,67,86880
2020-06-15,ND,3101,84675,68,87776
2020-06-16,ND,3124,85527,69,88651
2020-06-17,ND,3166,86508,70,89674
2020-06-18,ND,3193,87461,70,90654
2020-06-19,ND,3226,89380,71,92606
2020-06-20,ND,3251,90980,71,94231
2020-06-21,ND,3288,92885,71,96173
2020-06-22,ND,3313,94140,72,97453
2020-06-23,ND,3320,94233,73,97553
2020-06-24,ND,3362,95327,74,98689
2020-06-25,ND,3393,96051,76,99444
2020-06-26,ND,3421,97465,77,100886
2020-06-27,ND,3458,99061,77,102519
2020-06-28,ND,3495,100430,77,103925
2020-06-29,ND,3539,102152,77,105691
2020-06-30,ND,3576,102546,78,106122
2020-07-01,ND,3615,103611,78,107226
2020-07-02,ND,3657,104538,78,108195
2020-07-03,ND,3722,106852,78,110574
2020-07-04,ND,3779,108149,78,111928
2020-07-05,ND,3816,109312,78,113128
2020-07-06,ND,3849,109733,78,113582
2020-07-07,ND,3898,110459,81,114357
2020-07-08,ND,3971,111868,78,115839
2020-07-09,ND,4070,113779,78,117849
2020-07-10,ND,4154,115442,78,119596
2020-07-11,ND,4243,116608,78,120851
2020-07-12,ND,4334,118145,78,122479
2020-07-13,ND,4442,119436,78,123878
2020-07-14,ND,4493,120540,78,125033
2020-07-15,ND,4565,121999,81,126564
2020-07-16,ND,4668,123388,82,128056
2020-07-17,ND,4792,124683,82,129475
2020-07-18,ND,4907,126608,82,131515
2020-07-19,ND,5019,128835,82,133854
2020-07-20,ND,5126,130852,82,135978
2020-07-21,ND,5207,132086,84,137293
2020-07-22,ND,5367,133899,88,139266
2020-07-23,ND,5493,135323,88,140816
2020-03-05,NE,0,17,0,17
2020-03-06,NE,0,17,0,17
2020-03-07,NE,1,17,0,18
2020-03-08,NE,1,17,0,18
2020-03-09,NE,3,36,0,39
2020-03-10,NE,3,47,0,50
2020-03-11,NE,5,47,0,52
2020-03-12,NE,10,80,0,90
2020-03-13,NE,13,80,0,93
2020-03-14,NE,14,80,0,94
2020-03-15,NE,17,80,0,97
2020-03-16,NE,18,170,0,188
2020-03-17,NE,21,206,0,227
2020-03-18,NE,24,206,0,230
2020-03-19,NE,27,240,0,267
2020-03-20,NE,32,240,0,272
2020-03-21,NE,38,356,0,394
2020-03-22,NE,48,356,0,404
2020-03-23,NE,50,356,0,406
2020-03-24,NE,52,975,0,1027
2020-03-25,NE,61,1304,0,1365
2020-03-26,NE,73,1584,0,1657
2020-03-27,NE,85,1761,0,1846
2020-03-28,NE,96,1904,2,2000
2020-03-29,NE,108,1968,2,2076
2020-03-30,NE,145,2584,2,2729
2020-03-31,NE,172,2931,3,3103
2020-04-01,NE,210,3475,4,3685
2020-04-02,NE,246,3978,5,4224
2020-04-03,NE,279,4487,6,4766
2020-04-04,NE,321,5058,6,5379
2020-04-05,NE,363,5558,8,5921
2020-04-06,NE,409,6378,8,6787
2020-04-07,NE,447,6811,10,7258
2020-04-08,NE,519,7442,12,7961
2020-04-09,NE,567,8116,14,8683
2020-04-10,NE,635,8719,15,9354
2020-04-11,NE,700,9285,17,9985
2020-04-12,NE,791,9900,17,10691
2020-04-13,NE,814,10158,17,10972
2020-04-14,NE,871,10486,18,11357
2020-04-15,NE,901,10828,20,11729
2020-04-16,NE,952,11342,21,12294
2020-04-17,NE,1066,12038,24,13104
2020-04-18,NE,1138,12539,24,13677
2020-04-19,NE,1287,13288,28,14575
2020-04-20,NE,1474,14206,28,15680
2020-04-21,NE,1648,14724,33,16372
2020-04-22,NE,1722,14957,38,16679
2020-04-23,NE,1813,15547,45,17360
2020-04-24,NE,2124,16488,47,18612
2020-04-25,NE,2421,17552,50,19973
2020-04-26,NE,2732,18496,53,21228
2020-04-27,NE,3028,19335,56,22363
2020-04-28,NE,3358,20247,55,23605
2020-04-29,NE,3374,20257,55,23631
2020-04-30,NE,3784,21537,68,25321
2020-05-01,NE,4281,23104,70,27385
2020-05-02,NE,4838,24510,73,29348
2020-05-03,NE,5326,25936,76,31262
2020-05-04,NE,5910,27844,78,33754
2020-05-05,NE,6083,28526,78,34609
2020-05-06,NE,6438,29690,82,36128
2020-05-07,NE,6771,30987,86,37758
2020-05-08,NE,7190,33222,90,40412
2020-05-09,NE,7831,35145,92,42976
2020-05-10,NE,8234,37335,96,45569
2020-05-11,NE,8315,37924,98,46239
2020-05-12,NE,8572,39371,100,47943
2020-05-13,NE,8692,41033,103,49725
2020-05-14,NE,9075,44266,107,53341
2020-05-15,NE,9416,47799,113,57215
2020-05-16,NE,9772,50206,119,59978
2020-05-17,NE,10220,55420,123,65640
2020-05-18,NE,10348,57153,123,67501
2020-05-19,NE,10625,59359,125,69984
2020-05-20,NE,10846,61289,132,72135
2020-05-21,NE,11122,64518,138,75640
2020-05-22,NE,11425,66994,143,78419
2020-05-23,NE,11662,68320,147,79982
2020-05-24,NE,11989,71216,147,83205
2020-05-25,NE,12134,73598,150,85732
2020-05-26,NE,12355,75687,150,88042
2020-05-27,NE,12619,77802,153,90421
2020-05-28,NE,12976,80004,163,92980
2020-05-29,NE,13261,81542,164,94803
2020-05-30,NE,13654,85354,170,99008
2020-05-31,NE,13905,87237,170,101142
2020-06-01,NE,14101,89564,170,103665
2020-06-02,NE,14345,92073,178,106418
2020-06-03,NE,14611,95355,181,109966
2020-06-04,NE,14866,97389,187,112255
2020-06-05,NE,15117,99705,186,114822
2020-06-06,NE,15379,102168,186,117547
2020-06-07,NE,15543,104226,188,119769
2020-06-08,NE,15634,105773,188,121407
2020-06-09,NE,15752,106940,188,122692
2020-06-10,NE,15883,109279,191,125162
2020-06-11,NE,16025,111637,195,127662
2020-06-12,NE,16315,114458,212,130773
2020-06-13,NE,16513,117864,216,134377
2020-06-14,NE,16633,119482,216,136115
2020-06-15,NE,16725,121030,216,137755
2020-06-16,NE,16851,122662,220,139513
2020-06-17,NE,17031,125356,231,142387
2020-06-18,NE,17226,127587,234,144813
2020-06-19,NE,17415,130431,240,147846
2020-06-20,NE,17591,134263,244,151854
2020-06-21,NE,17707,136534,244,154241
2020-06-22,NE,17810,138698,244,156508
2020-06-23,NE,17957,140685,249,158642
2020-06-24,NE,18092,143209,256,161301
2020-06-25,NE,18221,144949,257,163170
2020-06-26,NE,18346,146656,260,165002
2020-06-27,NE,18524,150074,266,168598
2020-06-28,NE,18775,154023,267,172798
2020-06-29,NE,18899,156373,267,175272
2020-06-30,NE,19042,159115,269,178157
2020-07-01,NE,19177,161431,274,180608
2020-07-02,NE,19310,163352,276,182662
2020-07-03,NE,19452,164682,282,184134
2020-07-04,NE,19660,167928,284,187588
2020-07-05,NE,19827,170101,284,189928
2020-07-06,NE,19929,171811,284,191740
2020-07-07,NE,20046,173027,283,193073
2020-07-08,NE,20201,174847,282,195048
2020-07-09,NE,20425,177410,282,197835
2020-07-10,NE,20623,180391,284,201014
2020-07-11,NE,20777,183077,286,203854
2020-07-12,NE,20998,187105,285,208103
2020-07-13,NE,21172,190487,285,211659
2020-07-14,NE,21399,194836,288,216235
2020-07-15,NE,21717,198026,286,219743
2020-07-16,NE,21979,201250,291,223229
2020-07-17,NE,22134,204062,299,226196
2020-07-18,NE,22361,208790,301,231151
2020-07-19,NE,22481,209920,301,232401
2020-07-20,NE,22583,212313,301,234896
2020-07-21,NE,22847,215594,306,238441
2020-07-22,NE,23190,219431,310,242621
2020-07-23,NE,23486,222087,311,245573
2020-03-04,NH,2,10,0,12
2020-03-05,NH,2,16,0,18
2020-03-06,NH,2,20,0,22
2020-03-07,NH,2,20,0,22
2020-03-08,NH,4,38,0,42
2020-03-09,NH,4,38,0,42
2020-03-10,NH,4,38,0,42
2020-03-11,NH,4,38,0,42
2020-03-12,NH,6,94,0,100
2020-03-13,NH,6,94,0,100
2020-03-14,NH,7,212,0,219
2020-03-15,NH,13,271,0,284
2020-03-16,NH,13,271,0,284
2020-03-17,NH,17,355,0,372
2020-03-18,NH,26,513,0,539
2020-03-19,NH,39,621,0,660
2020-03-20,NH,44,745,0,789
2020-03-21,NH,55,973,0,1028
2020-03-22,NH,65,1188,0,1253
2020-03-23,NH,78,1374,0,1452
2020-03-24,NH,101,1447,1,1548
2020-03-25,NH,108,2356,1,2464
2020-03-26,NH,137,3001,1,3138
2020-03-27,NH,158,3395,1,3553
2020-03-28,NH,187,3656,2,3843
2020-03-29,NH,214,4524,2,4738
2020-03-30,NH,314,5386,3,5700
2020-03-31,NH,314,5413,3,5727
2020-04-01,NH,415,5985,4,6400
2020-04-02,NH,415,6078,4,6493
2020-04-03,NH,479,6575,5,7054
2020-04-04,NH,540,6965,7,7505
2020-04-05,NH,621,7411,9,8032
2020-04-06,NH,669,7701,9,8370
2020-04-07,NH,715,8019,9,8734
2020-04-08,NH,788,8389,18,9177
2020-04-09,NH,788,8763,18,9551
2020-04-10,NH,819,9139,21,9958
2020-04-11,NH,885,9608,22,10493
2020-04-12,NH,929,9996,23,10925
2020-04-13,NH,985,10222,23,11207
2020-04-14,NH,1020,10590,23,11610
2020-04-15,NH,1139,11027,32,12166
2020-04-16,NH,1139,11027,32,12166
2020-04-17,NH,1287,11421,37,12708
2020-04-18,NH,1287,11565,37,12852
2020-04-19,NH,1342,12082,38,13424
2020-04-20,NH,1392,12726,41,14118
2020-04-21,NH,1491,12848,42,14339
2020-04-22,NH,1491,13550,42,15041
2020-04-23,NH,1588,14424,48,16012
2020-04-24,NH,1670,15139,51,16809
2020-04-25,NH,1720,16007,53,17727
2020-04-26,NH,1787,16964,60,18751
2020-04-27,NH,1864,17860,60,19724
2020-04-28,NH,1938,18207,60,20145
2020-04-29,NH,2010,18736,60,20746
2020-04-30,NH,2054,19867,66,21921
2020-05-01,NH,2146,19903,72,22049
2020-05-02,NH,2310,22039,81,24349
2020-05-03,NH,2429,25964,84,28393
2020-05-04,NH,2588,24282,86,26870
2020-05-05,NH,2588,24282,86,26870
2020-05-06,NH,2636,25097,92,27733
2020-05-07,NH,2740,26066,111,28806
2020-05-08,NH,2843,27829,114,30672
2020-05-09,NH,2947,29351,121,32298
2020-05-10,NH,3011,30442,131,33453
2020-05-11,NH,3160,31723,133,34883
2020-05-12,NH,3160,32401,133,35561
2020-05-13,NH,3239,33977,142,37216
2020-05-14,NH,3299,35876,150,39175
2020-05-15,NH,3464,39148,159,42612
2020-05-16,NH,3464,39212,159,42676
2020-05-17,NH,3556,41196,171,44752
2020-05-18,NH,3596,41282,172,44878
2020-05-19,NH,3652,45822,172,49474
2020-05-20,NH,3721,47167,182,50888
2020-05-21,NH,3868,48962,190,52830
2020-05-22,NH,3935,51165,199,55100
2020-05-23,NH,4089,55450,208,59539
2020-05-24,NH,4089,55450,208,59539
2020-05-25,NH,4149,57237,209,61386
2020-05-26,NH,4197,58842,210,63039
2020-05-27,NH,4231,60001,214,64232
2020-05-28,NH,4286,61310,223,65596
2020-05-29,NH,4386,62476,232,66862
2020-05-30,NH,4492,64468,238,68960
2020-05-31,NH,4545,65735,242,70280
2020-06-01,NH,4651,67805,245,72456
2020-06-02,NH,4685,69659,245,74344
2020-06-03,NH,4749,70990,256,75739
2020-06-04,NH,4795,71170,265,75965
2020-06-05,NH,4876,74889,273,79765
2020-06-06,NH,5019,78990,283,84009
2020-06-07,NH,5019,78990,283,84009
2020-06-08,NH,5043,80509,286,85552
2020-06-09,NH,5079,82044,286,87123
2020-06-10,NH,5132,83515,294,88647
2020-06-11,NH,5178,84729,301,89907
2020-06-12,NH,5209,86708,308,91917
2020-06-13,NH,5251,88705,315,93956
2020-06-14,NH,5299,91122,318,96421
2020-06-15,NH,5345,93528,320,98873
2020-06-16,NH,5345,93528,320,98873
2020-06-17,NH,5364,94722,326,100086
2020-06-18,NH,5436,96548,330,101984
2020-06-19,NH,5450,98275,331,103725
2020-06-20,NH,5486,100081,337,105567
2020-06-21,NH,5518,100367,339,105885
2020-06-22,NH,5544,103318,339,108862
2020-06-23,NH,5558,103318,339,108876
2020-06-24,NH,5571,104482,343,110053
2020-06-25,NH,5598,105968,347,111566
2020-06-26,NH,5671,109097,365,114768
2020-06-27,NH,5671,109097,365,114768
2020-06-28,NH,5717,110392,367,116109
2020-06-29,NH,5760,112538,367,118298
2020-06-30,NH,5760,112538,367,118298
2020-07-01,NH,5782,113387,371,119169
2020-07-02,NH,5802,114505,373,120307
2020-07-03,NH,5822,116365,375,122187
2020-07-04,NH,5857,117892,376,123749
2020-07-05,NH,5857,117892,376,123749
2020-07-06,NH,5897,119338,381,125235
2020-07-07,NH,5914,121966,382,127880
2020-07-08,NH,5932,122579,384,128511
2020-07-09,NH,5952,123676,386,129628
2020-07-10,NH,5973,125078,387,131051
2020-07-11,NH,5991,126311,390,132302
2020-07-12,NH,6024,127365,391,133389
2020-07-13,NH,6054,128812,391,134866
2020-07-14,NH,6068,129960,391,136028
2020-07-15,NH,6091,131018,392,137109
2020-07-16,NH,6113,132159,394,138272
2020-07-17,NH,6165,135621,395,141786
2020-07-18,NH,6165,135621,395,141786
2020-07-19,NH,6203,137175,398,143378
2020-07-20,NH,6203,137175,398,143378
2020-07-21,NH,6249,138573,398,144822
2020-07-22,NH,6262,139276,400,145538
2020-07-23,NH,6295,140584,402,146879
2020-03-05,NJ,1,0,0,1
2020-03-06,NJ,1,0,0,1
2020-03-07,NJ,4,0,0,4
2020-03-08,NJ,6,31,0,37
2020-03-09,NJ,11,35,0,46
2020-03-10,NJ,15,44,0,59
2020-03-11,NJ,24,57,1,81
2020-03-12,NJ,30,74,1,104
2020-03-13,NJ,50,97,1,147
2020-03-14,NJ,50,97,1,147
2020-03-15,NJ,98,120,2,218
2020-03-16,NJ,178,120,2,298
2020-03-17,NJ,267,163,3,430
2020-03-18,NJ,427,190,5,617
2020-03-19,NJ,742,210,9,952
2020-03-20,NJ,890,264,11,1154
2020-03-21,NJ,1327,294,16,1621
2020-03-22,NJ,1914,327,20,2241
2020-03-23,NJ,2844,359,27,3203
2020-03-24,NJ,3675,8325,44,12000
2020-03-25,NJ,4402,10452,62,14854
2020-03-26,NJ,6876,13661,81,20537
2020-03-27,NJ,8825,16547,108,25372
2020-03-28,NJ,11124,19386,140,30510
2020-03-29,NJ,13386,22216,161,35602
2020-03-30,NJ,16636,25224,198,41860
2020-03-31,NJ,18696,27077,267,45773
2020-04-01,NJ,22255,30387,355,52642
2020-04-02,NJ,25590,33520,537,59110
2020-04-03,NJ,29895,37608,646,67503
2020-04-04,NJ,34124,41232,846,75356
2020-04-05,NJ,37505,44661,917,82166
2020-04-06,NJ,41090,47942,1003,89032
2020-04-07,NJ,44416,50558,1232,94974
2020-04-08,NJ,47437,52979,1504,100416
2020-04-09,NJ,51027,56165,1700,107192
2020-04-10,NJ,54588,58935,1932,113523
2020-04-11,NJ,58151,62042,2183,120193
2020-04-12,NJ,61850,64885,2350,126735
2020-04-13,NJ,64584,64885,2443,129469
2020-04-14,NJ,68824,70950,2805,139774
2020-04-15,NJ,71030,72991,3156,144021
2020-04-16,NJ,75317,76513,3518,151830
2020-04-17,NJ,78467,78982,3840,157449
2020-04-18,NJ,81420,81116,4070,162536
2020-04-19,NJ,85301,85387,4202,170688
2020-04-20,NJ,88806,89251,4377,178057
2020-04-21,NJ,92387,92439,4753,184826
2020-04-22,NJ,95865,95794,5063,191659
2020-04-23,NJ,99989,100159,5368,200148
2020-04-24,NJ,102196,103766,5617,205962
2020-04-25,NJ,105523,108163,5863,213686
2020-04-26,NJ,109038,114106,5938,223144
2020-04-27,NJ,111188,116587,6044,227775
2020-04-28,NJ,113856,120503,6442,234359
2020-04-29,NJ,116264,125054,6770,241318
2020-04-30,NJ,118652,129266,7228,247918
2020-05-01,NJ,121190,135355,7538,256545
2020-05-02,NJ,123717,138595,7742,262312
2020-05-03,NJ,126744,148322,7871,275066
2020-05-04,NJ,128269,148951,7910,277220
2020-05-05,NJ,130593,157030,8244,287623
2020-05-06,NJ,131890,157030,8549,288920
2020-05-07,NJ,133635,159023,8801,292658
2020-05-08,NJ,135454,163305,8952,298759
2020-05-09,NJ,137085,168121,9116,305206
2020-05-10,NJ,138532,173915,9255,312447
2020-05-11,NJ,139945,285988,9310,425933
2020-05-12,NJ,140743,292317,9508,433060
2020-05-13,NJ,141560,299890,9702,441450
2020-05-14,NJ,142704,308992,9946,451696
2020-05-15,NJ,143905,319067,10138,462972
2020-05-16,NJ,145089,330135,10249,475224
2020-05-17,NJ,146334,341231,10356,487565
2020-05-18,NJ,148039,357530,10435,505569
2020-05-19,NJ,149013,371169,10586,520182
2020-05-20,NJ,150399,380944,10747,531343
2020-05-21,NJ,151472,392802,10843,544274
2020-05-22,NJ,152719,402595,10985,555314
2020-05-23,NJ,153104,425631,11081,578735
2020-05-24,NJ,154154,449653,11133,603807
2020-05-25,NJ,155092,468705,11144,623797
2020-05-26,NJ,155764,480128,11191,635892
2020-05-27,NJ,156628,503697,11339,660325
2020-05-28,NJ,157815,528042,11401,685857
2020-05-29,NJ,158844,557567,11531,716411
2020-05-30,NJ,159608,585700,11634,745308
2020-05-31,NJ,160445,585700,11698,746145
2020-06-01,NJ,160918,634682,11721,795600
2020-06-02,NJ,161545,656132,11770,817677
2020-06-03,NJ,162068,675352,11880,837420
2020-06-04,NJ,162530,695199,11970,857729
2020-06-05,NJ,163336,755555,12049,918891
2020-06-06,NJ,163893,755555,12106,919448
2020-06-07,NJ,164164,796261,12176,960425
2020-06-08,NJ,164497,810592,12214,975089
2020-06-09,NJ,164796,824701,12303,989497
2020-06-10,NJ,165346,843588,12377,1008934
2020-06-11,NJ,165816,864977,12443,1030793
2020-06-12,NJ,166164,889232,12489,1055396
2020-06-13,NJ,166605,911610,12589,1078215
2020-06-14,NJ,166881,930735,12625,1097616
2020-06-15,NJ,167103,948980,12676,1116083
2020-06-16,NJ,167426,964356,12727,1131782
2020-06-17,NJ,167703,980138,12769,1147841
2020-06-18,NJ,168107,1003627,12800,1171734
2020-06-19,NJ,168496,1025847,12835,1194343
2020-06-20,NJ,168834,1050039,12857,1218873
2020-06-21,NJ,169142,1075825,12870,1244967
2020-06-22,NJ,169415,1097984,12895,1267399
2020-06-23,NJ,169734,1113717,12949,1283451
2020-06-24,NJ,169892,1129753,12995,1299645
2020-06-25,NJ,170196,1150714,14872,1320910
2020-06-26,NJ,170584,1176088,14914,1346672
2020-06-27,NJ,170873,1196377,14948,1367250
2020-06-28,NJ,171182,1216651,14975,1387833
2020-06-29,NJ,171272,1232712,14992,1403984
2020-06-30,NJ,171667,1250707,15035,1422374
2020-07-01,NJ,171928,1271009,15078,1442937
2020-07-02,NJ,172356,1291557,15107,1463913
2020-07-03,NJ,172742,1312759,15164,1485501
2020-07-04,NJ,173033,1335515,15189,1508548
2020-07-05,NJ,173402,1361238,15211,1534640
2020-07-06,NJ,173611,1375598,15229,1549209
2020-07-07,NJ,173878,1386255,15281,1560133
2020-07-08,NJ,174039,1403809,15423,1577848
2020-07-09,NJ,174240,1425177,15448,1599417
2020-07-10,NJ,174628,1448530,15479,1623158
2020-07-11,NJ,174959,1486325,15525,1661284
2020-07-12,NJ,175298,1510306,15541,1685604
2020-07-13,NJ,175522,1524863,15560,1700385
2020-07-14,NJ,175915,1545316,15582,1721231
2020-07-15,NJ,176278,1566069,15607,1742347
2020-07-16,NJ,176501,1583403,15665,1759904
2020-07-17,NJ,176551,1592377,15684,1768928
2020-07-18,NJ,176814,1604636,15699,1781450
2020-07-19,NJ,176783,1614354,15706,1791137
2020-07-20,NJ,176963,1625911,15715,1802874
2020-07-21,NJ,177256,1640699,15737,1817955
2020-07-22,NJ,177645,1663284,15707,1840929
2020-07-23,NJ,177887,1681751,15730,1859638
2020-03-06,NM,0,16,0,16
2020-03-07,NM,0,48,0,48
2020-03-08,NM,0,48,0,48
2020-03-09,NM,0,57,0,57
2020-03-10,NM,0,69,0,69
2020-03-11,NM,3,87,0,90
2020-03-12,NM,5,155,0,160
2020-03-13,NM,10,190,0,200
2020-03-14,NM,10,237,0,247
2020-03-15,NM,13,482,0,495
2020-03-16,NM,17,566,0,583
2020-03-17,NM,23,1249,0,1272
2020-03-18,NM,28,2326,0,2354
2020-03-19,NM,35,2762,0,2797
2020-03-20,NM,43,3771,0,3814
2020-03-21,NM,57,3771,0,3828
2020-03-22,NM,57,4722,0,4779
2020-03-23,NM,65,5321,0,5386
2020-03-24,NM,83,5890,0,5973
2020-03-25,NM,100,6742,1,6842
2020-03-26,NM,112,7681,1,7793
2020-03-27,NM,136,8377,1,8513
2020-03-28,NM,191,9196,1,9387
2020-03-29,NM,237,10769,2,11006
2020-03-30,NM,237,10942,2,11179
2020-03-31,NM,281,12246,4,12527
2020-04-01,NM,315,12925,5,13240
2020-04-02,NM,363,13648,6,14011
2020-04-03,NM,403,14375,7,14778
2020-04-04,NM,495,15137,10,15632
2020-04-05,NM,543,16285,11,16828
2020-04-06,NM,624,18512,12,19136
2020-04-07,NM,686,21139,12,21825
2020-04-08,NM,794,21451,13,22245
2020-04-09,NM,865,22942,16,23807
2020-04-10,NM,1091,26007,19,27098
2020-04-11,NM,1091,26007,19,27098
2020-04-12,NM,1174,27518,20,28692
2020-04-13,NM,1245,29270,26,30515
2020-04-14,NM,1345,30625,31,31970
2020-04-15,NM,1407,31443,36,32850
2020-04-16,NM,1484,31910,36,33394
2020-04-17,NM,1597,32891,44,34488
2020-04-18,NM,1711,33902,51,35613
2020-04-19,NM,1798,34834,53,36632
2020-04-20,NM,1845,35197,55,37042
2020-04-21,NM,1971,36784,58,38755
2020-04-22,NM,2072,38805,65,40877
2020-04-23,NM,2210,39022,71,41232
2020-04-24,NM,2379,44184,78,46563
2020-04-25,NM,2521,48989,84,51510
2020-04-26,NM,2660,51075,93,53735
2020-04-27,NM,2726,53889,99,56615
2020-04-28,NM,2823,55980,104,58803
2020-04-29,NM,2974,58771,110,61745
2020-04-30,NM,3213,61872,112,65085
2020-05-01,NM,3411,64458,123,67869
2020-05-02,NM,3513,67605,131,71118
2020-05-03,NM,3732,71212,139,74944
2020-05-04,NM,3850,74127,151,77977
2020-05-05,NM,4031,77689,156,81720
2020-05-06,NM,4138,79113,162,83251
2020-05-07,NM,4291,81393,169,85684
2020-05-08,NM,4493,84539,172,89032
2020-05-09,NM,4673,88589,181,93262
2020-05-10,NM,4778,92275,191,97053
2020-05-11,NM,4863,97635,200,102498
2020-05-12,NM,5069,101652,208,106721
2020-05-13,NM,5212,105077,219,110289
2020-05-14,NM,5364,109647,231,115011
2020-05-15,NM,5503,114098,242,119601
2020-05-16,NM,5662,118796,253,124458
2020-05-17,NM,5857,122727,259,128584
2020-05-18,NM,5938,127315,265,133253
2020-05-19,NM,6096,131524,270,137620
2020-05-20,NM,6192,136054,276,142246
2020-05-21,NM,6317,141027,283,147344
2020-05-22,NM,6472,146295,294,152767
2020-05-23,NM,6625,151758,302,158383
2020-05-24,NM,6795,162324,308,169119
2020-05-25,NM,6943,166538,317,173481
2020-05-26,NM,7026,170335,320,177361
2020-05-27,NM,7130,173516,325,180646
2020-05-28,NM,7252,172291,329,179543
2020-05-29,NM,7364,176180,335,183544
2020-05-30,NM,7493,180768,344,188261
2020-05-31,NM,7624,186823,351,194447
2020-06-01,NM,7689,191915,356,199604
2020-06-02,NM,7800,195315,362,203115
2020-06-03,NM,8024,198813,367,206837
2020-06-04,NM,8140,204856,375,212996
2020-06-05,NM,8353,209404,383,217757
2020-06-06,NM,8672,215968,387,224640
2020-06-07,NM,8800,220347,392,229147
2020-06-08,NM,8940,225435,396,234375
2020-06-09,NM,9062,229739,400,238801
2020-06-10,NM,9105,232552,404,241657
2020-06-11,NM,9250,236307,410,245557
2020-06-12,NM,9526,245758,426,255284
2020-06-13,NM,9526,245758,426,255284
2020-06-14,NM,9621,249373,431,258994
2020-06-15,NM,9723,253942,435,263665
2020-06-16,NM,9845,258076,440,267921
2020-06-17,NM,9933,261620,447,271553
2020-06-18,NM,10065,265832,452,275897
2020-06-19,NM,10153,270022,456,280175
2020-06-20,NM,10260,274342,464,284602
2020-06-21,NM,10565,282866,469,293431
2020-06-22,NM,10565,282866,469,293431
2020-06-23,NM,10694,287382,469,298076
2020-06-24,NM,10838,291245,476,302083
2020-06-25,NM,10990,297115,480,308105
2020-06-26,NM,11192,303478,485,314670
2020-06-27,NM,11408,309230,489,320638
2020-06-28,NM,11619,311340,491,322959
2020-06-29,NM,11809,319239,492,331048
2020-06-30,NM,11982,325738,493,337720
2020-07-01,NM,12147,332034,497,344181
2020-07-02,NM,12276,337784,500,350060
2020-07-03,NM,12520,344117,503,356637
2020-07-04,NM,12776,350598,511,363374
2020-07-05,NM,13063,359225,513,372288
2020-07-06,NM,13256,361798,513,375054
2020-07-07,NM,13507,366733,515,380240
2020-07-08,NM,13727,371515,519,385242
2020-07-09,NM,14017,375670,527,389687
2020-07-10,NM,14251,381630,533,395881
2020-07-11,NM,14549,389032,539,403581
2020-07-12,NM,14773,395981,543,410754
2020-07-13,NM,15028,403329,545,418357
2020-07-14,NM,15291,409064,548,424355
2020-07-15,NM,15514,414492,551,430006
2020-07-16,NM,15841,421164,557,437005
2020-07-17,NM,16138,427230,562,443368
2020-07-18,NM,16456,435842,565,452298
2020-07-19,NM,16736,443928,569,460664
2020-07-20,NM,16971,452244,571,469215
2020-07-21,NM,17215,459282,578,476497
2020-07-22,NM,17517,464014,588,481531
2020-07-23,NM,17828,471506,591,489334
2020-03-05,NV,1,14,0,15
2020-03-06,NV,1,14,0,15
2020-03-07,NV,1,14,0,15
2020-03-08,NV,1,14,0,15
2020-03-09,NV,1,14,0,15
2020-03-10,NV,1,14,0,15
2020-03-11,NV,5,168,0,173
2020-03-12,NV,7,168,0,175
2020-03-13,NV,11,168,0,179
2020-03-14,NV,20,168,0,188
2020-03-15,NV,21,168,1,189
2020-03-16,NV,45,168,1,213
2020-03-17,NV,55,168,1,223
2020-03-18,NV,55,168,2,223
2020-03-19,NV,95,1626,3,1721
2020-03-20,NV,109,1992,3,2101
2020-03-21,NV,124,2384,5,2508
2020-03-22,NV,190,2448,7,2638
2020-03-23,NV,245,3490,8,3735
2020-03-24,NV,278,3954,13,4232
2020-03-25,NV,321,4251,13,4572
2020-03-26,NV,420,4697,17,5117
2020-03-27,NV,535,6161,21,6696
2020-03-28,NV,621,7901,25,8522
2020-03-29,NV,738,8412,28,9150
2020-03-30,NV,1008,10207,32,11215
2020-03-31,NV,1113,10681,37,11794
2020-04-01,NV,1279,11519,45,12798
2020-04-02,NV,1458,12588,51,14046
2020-04-03,NV,1514,13018,59,14532
2020-04-04,NV,1742,14421,70,16163
2020-04-05,NV,1836,14995,76,16831
2020-04-06,NV,1953,15676,79,17629
2020-04-07,NV,2087,16552,91,18639
2020-04-08,NV,2318,18248,101,20566
2020-04-09,NV,2456,19315,110,21771
2020-04-10,NV,2584,20165,120,22749
2020-04-11,NV,2700,20887,125,23587
2020-04-12,NV,2836,21775,128,24611
2020-04-13,NV,2971,22493,133,25464
2020-04-14,NV,3088,23573,141,26661
2020-04-15,NV,3211,24444,150,27655
2020-04-16,NV,3321,25130,158,28451
2020-04-17,NV,3524,26238,162,29762
2020-04-18,NV,3626,27125,168,30751
2020-04-19,NV,3728,27870,172,31598
2020-04-20,NV,3830,28517,180,32347
2020-04-21,NV,3937,29118,193,33055
2020-04-22,NV,4081,29807,201,33888
2020-04-23,NV,4208,30541,210,34749
2020-04-24,NV,4398,31794,216,36192
2020-04-25,NV,4539,32669,229,37208
2020-04-26,NV,4602,33584,235,38186
2020-04-27,NV,4690,34123,245,38813
2020-04-28,NV,4805,35314,251,40119
2020-04-29,NV,4898,36130,257,41028
2020-04-30,NV,4998,36988,269,41986
2020-05-01,NV,5227,38368,277,43595
2020-05-02,NV,5311,39076,281,44387
2020-05-03,NV,5426,39843,287,45269
2020-05-04,NV,5491,40675,292,46166
2020-05-05,NV,5594,42290,297,47884
2020-05-06,NV,5663,43612,311,49275
2020-05-07,NV,5766,45591,320,51357
2020-05-08,NV,5884,47460,328,53344
2020-05-09,NV,6028,50083,334,56111
2020-05-10,NV,6098,52711,339,58809
2020-05-11,NV,6152,53932,344,60084
2020-05-12,NV,6311,57764,350,64075
2020-05-13,NV,6394,60278,355,66672
2020-05-14,NV,6499,62985,358,69484
2020-05-15,NV,6614,65532,368,72146
2020-05-16,NV,6662,67002,369,73664
2020-05-17,NV,6857,73780,375,80637
2020-05-18,NV,6906,74926,383,81832
2020-05-19,NV,7046,80509,390,87555
2020-05-20,NV,7166,84005,393,91171
2020-05-21,NV,7255,87127,397,94382
2020-05-22,NV,7401,92540,400,99941
2020-05-23,NV,7696,99351,404,107047
2020-05-24,NV,7770,102511,408,110281
2020-05-25,NV,7879,106852,410,114731
2020-05-26,NV,7997,115370,412,123367
2020-05-27,NV,8113,120446,416,128559
2020-05-28,NV,8208,122982,425,131190
2020-05-29,NV,8350,126066,435,134416
2020-05-30,NV,8495,130037,439,138532
2020-05-31,NV,8593,133967,444,142560
2020-06-01,NV,8688,138095,445,146783
2020-06-02,NV,8830,143261,452,152091
2020-06-03,NV,8935,147320,455,156255
2020-06-04,NV,9090,152333,460,161423
2020-06-05,NV,9266,156841,460,166107
2020-06-06,NV,9460,162311,463,171771
2020-06-07,NV,9649,166048,465,175697
2020-06-08,NV,9786,170217,469,180003
2020-06-09,NV,10030,173559,472,183589
2020-06-10,NV,10164,177159,474,187323
2020-06-11,NV,10399,182855,475,193254
2020-06-12,NV,10678,188769,475,199447
2020-06-13,NV,10946,193934,478,204880
2020-06-14,NV,11173,199438,479,210611
2020-06-15,NV,11279,205155,483,216434
2020-06-16,NV,11658,210816,485,222474
2020-06-17,NV,11842,215768,486,227610
2020-06-18,NV,12076,218720,489,230796
2020-06-19,NV,12486,221874,491,234360
2020-06-20,NV,12931,226032,491,238963
2020-06-21,NV,13205,228486,492,241691
2020-06-22,NV,13535,230530,492,244065
2020-06-23,NV,13997,234529,492,248526
2020-06-24,NV,14362,238025,494,252387
2020-06-25,NV,14859,240691,495,255550
2020-06-26,NV,15240,243422,498,258662
2020-06-27,NV,16339,246687,500,263026
2020-06-28,NV,17160,250420,500,267580
2020-06-29,NV,17894,255123,504,273017
2020-06-30,NV,18456,259112,507,277568
2020-07-01,NV,19101,264995,511,284096
2020-07-02,NV,19733,264995,525,284728
2020-07-03,NV,20718,272967,528,293685
2020-07-04,NV,21575,279654,530,301229
2020-07-05,NV,22418,285279,534,307697
2020-07-06,NV,22909,288572,537,311481
2020-07-07,NV,23785,292761,548,316546
2020-07-08,NV,24301,299352,553,323653
2020-07-09,NV,24904,304874,571,329778
2020-07-10,NV,25908,309583,579,335491
2020-07-11,NV,26838,314395,592,341233
2020-07-12,NV,27683,319873,593,347556
2020-07-13,NV,28515,324678,593,353193
2020-07-14,NV,29619,330561,612,360180
2020-07-15,NV,30468,333957,618,364425
2020-07-16,NV,31915,338928,626,370843
2020-07-17,NV,33295,343712,637,377007
2020-07-18,NV,34477,348060,646,382537
2020-07-19,NV,35765,354023,647,389788
2020-07-20,NV,36713,358708,648,395421
2020-07-21,NV,37528,361294,676,398822
2020-07-22,NV,38657,365651,704,404308
2020-07-23,NV,39919,374217,709,414136
2020-03-04,NY,6,48,0,54
2020-03-05,NY,22,76,0,98
2020-03-06,NY,33,92,0,125
2020-03-07,NY,76,92,0,168
2020-03-08,NY,105,92,0,197
2020-03-09,NY,142,92,0,234
2020-03-10,NY,173,92,0,265
2020-03-11,NY,216,92,0,308
2020-03-12,NY,216,92,0,308
2020-03-13,NY,421,2779,0,3200
2020-03-14,NY,524,2779,0,3303
2020-03-15,NY,729,4543,3,5272
2020-03-16,NY,950,4543,7,5493
2020-03-17,NY,1700,5506,7,7206
2020-03-18,NY,2382,12215,12,14597
2020-03-19,NY,4152,18132,12,22284
2020-03-20,NY,7102,25325,35,32427
2020-03-21,NY,10356,35081,44,45437
2020-03-22,NY,15168,46233,114,61401
2020-03-23,NY,20875,57414,114,78289
2020-03-24,NY,25665,65605,210,91270
2020-03-25,NY,30811,72668,285,103479
2020-03-26,NY,37258,84846,385,122104
2020-03-27,NY,44635,101118,519,145753
2020-03-28,NY,52318,103616,728,155934
2020-03-29,NY,59513,112847,965,172360
2020-03-30,NY,66497,119971,1218,186468
2020-03-31,NY,75795,129391,1550,205186
2020-04-01,NY,83712,137168,1941,220880
2020-04-02,NY,92381,146584,2373,238965
2020-04-03,NY,102863,157657,2935,260520
2020-04-04,NY,113704,169917,3565,283621
2020-04-05,NY,122031,180249,4159,302280
2020-04-06,NY,130689,190122,4758,320811
2020-04-07,NY,138863,201195,5489,340058
2020-04-08,NY,149316,215837,6268,365153
2020-04-09,NY,159937,231612,7067,391549
2020-04-10,NY,170512,247373,7844,417885
2020-04-11,NY,180458,260522,8627,440980
2020-04-12,NY,188694,272907,9385,461601
2020-04-13,NY,195031,283326,10056,478357
2020-04-14,NY,202208,296935,10834,499143
2020-04-15,NY,213779,312233,11586,526012
2020-04-16,NY,222284,328295,12192,550579
2020-04-17,NY,229642,343581,12822,573223
2020-04-18,NY,236732,359800,13362,596532
2020-04-19,NY,242786,374769,13869,617555
2020-04-20,NY,247512,386349,14347,633861
2020-04-21,NY,251690,397635,14828,649325
2020-04-22,NY,257216,412766,15302,669982
2020-04-23,NY,263460,432460,15740,695920
2020-04-24,NY,271590,459066,16162,730656
2020-04-25,NY,282143,495425,16599,777568
2020-04-26,NY,288045,517305,16966,805350
2020-04-27,NY,291996,534099,17303,826095
2020-04-28,NY,295106,549888,17638,844994
2020-04-29,NY,299691,572790,18015,872481
2020-04-30,NY,304372,596264,18321,900636
2020-05-01,NY,308314,619124,18610,927438
2020-05-02,NY,312977,646094,18909,959071
2020-05-03,NY,316415,669496,19189,985911
2020-05-04,NY,318953,688357,19415,1007310
2020-05-05,NY,321192,707707,19645,1028899
2020-05-06,NY,323978,731943,19877,1055921
2020-05-07,NY,327649,762267,20828,1089916
2020-05-08,NY,330407,791136,21045,1121543
2020-05-09,NY,333122,820646,21271,1153768
2020-05-10,NY,335395,847603,21478,1182998
2020-05-11,NY,337055,867596,21640,1204651
2020-05-12,NY,338485,886628,21845,1225113
2020-05-13,NY,340661,918246,22013,1258907
2020-05-14,NY,343051,955706,22170,1298757
2020-05-15,NY,345813,992235,22304,1338048
2020-05-16,NY,348232,1030485,22478,1378717
2020-05-17,NY,350121,1063275,22619,1413396
2020-05-18,NY,351371,1088186,22729,1439557
2020-05-19,NY,352845,1114894,22843,1467739
2020-05-20,NY,354370,1151466,22976,1505836
2020-05-21,NY,356458,1198597,23083,1555055
2020-05-22,NY,358154,1242639,23195,1600793
2020-05-23,NY,359926,1292135,23282,1652061
2020-05-24,NY,361515,1338311,23391,1699826
2020-05-25,NY,362764,1376685,23488,1739449
2020-05-26,NY,363836,1410292,23564,1774128
2020-05-27,NY,364965,1446579,23643,1811544
2020-05-28,NY,366733,1510056,23722,1876789
2020-05-29,NY,368284,1575846,23780,1944130
2020-05-30,NY,369660,1635721,23848,2005381
2020-05-31,NY,370770,1693055,23905,2063825
2020-06-01,NY,371711,1742066,23959,2113777
2020-06-02,NY,373040,1794791,24023,2167831
2020-06-03,NY,374085,1855388,24079,2229473
2020-06-04,NY,375133,1917899,24133,2293032
2020-06-05,NY,376208,1983304,24175,2359512
2020-06-06,NY,377316,2060091,24212,2437407
2020-06-07,NY,378097,2119745,24259,2497842
2020-06-08,NY,378799,2177097,24299,2555896
2020-06-09,NY,379482,2226387,24348,2605869
2020-06-10,NY,380156,2288010,24404,2668166
2020-06-11,NY,380892,2348113,24442,2729005
2020-06-12,NY,381714,2419686,24495,2801400
2020-06-13,NY,382630,2489610,24527,2872240
2020-06-14,NY,383324,2551275,24551,2934599
2020-06-15,NY,383944,2607266,24579,2991210
2020-06-16,NY,384575,2667203,24608,3051778
2020-06-17,NY,385142,2725977,24629,3111119
2020-06-18,NY,385760,2793900,24661,3179660
2020-06-19,NY,386556,2872407,24686,3258963
2020-06-20,NY,387272,2940521,24710,3327793
2020-06-21,NY,387936,3007383,24725,3395319
2020-06-22,NY,388488,3063611,24739,3452099
2020-06-23,NY,389085,3111723,24766,3500808
2020-06-24,NY,389666,3162286,24782,3551952
2020-06-25,NY,390415,3229179,24800,3619594
2020-06-26,NY,391220,3290097,24814,3681317
2020-06-27,NY,391923,3362656,24830,3754579
2020-06-28,NY,392539,3423946,24835,3816485
2020-06-29,NY,392930,3469983,24842,3862913
2020-06-30,NY,393454,3521484,24855,3914938
2020-07-01,NY,394079,3577569,24866,3971648
2020-07-02,NY,394954,3646639,24877,4041593
2020-07-03,NY,395872,3712113,24885,4107985
2020-07-04,NY,396598,3773790,24896,4170388
2020-07-05,NY,397131,3836672,24904,4233803
2020-07-06,NY,397649,3890482,24913,4288131
2020-07-07,NY,398237,3946630,24924,4344867
2020-07-08,NY,398929,4003523,24944,4402452
2020-07-09,NY,399513,4068503,24959,4468016
2020-07-10,NY,400299,4141275,24968,4541574
2020-07-11,NY,401029,4209748,24974,4610777
2020-07-12,NY,401706,4271489,24979,4673195
2020-07-13,NY,402263,4322619,24989,4724882
2020-07-14,NY,403175,4381752,24994,4784927
2020-07-15,NY,404006,4444519,25003,4848525
2020-07-16,NY,404775,4516435,25014,4921210
2020-07-17,NY,405551,4593898,25024,4999449
2020-07-18,NY,406305,4662961,25035,5069266
2020-07-19,NY,406807,4708663,25048,5115470
2020-07-20,NY,407326,4757486,25056,5164812
2020-07-21,NY,408181,4822800,25058,5230981
2020-07-22,NY,408886,4889754,25068,5298640
2020-07-23,NY,409697,4958641,25081,5368338
2020-03-05,OH,0,7,0,7
2020-03-06,OH,0,8,0,8
2020-03-07,OH,0,9,0,9
2020-03-08,OH,0,10,0,10
2020-03-09,OH,3,11,0,14
2020-03-10,OH,3,14,0,17
2020-03-11,OH,4,21,0,25
2020-03-12,OH,5,30,0,35
2020-03-13,OH,13,50,0,63
2020-03-14,OH,13,50,0,63
2020-03-15,OH,36,139,0,175
2020-03-16,OH,50,140,0,190
2020-03-17,OH,67,140,0,207
2020-03-18,OH,88,140,0,228
2020-03-19,OH,119,140,0,259
2020-03-20,OH,169,140,1,309
2020-03-21,OH,247,140,3,387
2020-03-22,OH,351,140,3,491
2020-03-23,OH,442,140,6,582
2020-03-24,OH,564,140,8,704
2020-03-25,OH,704,14060,10,14764
2020-03-26,OH,867,16449,15,17316
2020-03-27,OH,1137,19012,19,20149
2020-03-28,OH,1406,19012,25,20418
2020-03-29,OH,1653,19012,29,20665
2020-03-30,OH,1933,25342,39,27275
2020-03-31,OH,2199,26992,55,29191
2020-04-01,OH,2547,26992,65,29539
2020-04-02,OH,2902,32016,81,34918
2020-04-03,OH,3312,35063,91,38375
2020-04-04,OH,3739,38132,102,41871
2020-04-05,OH,4043,39713,119,43756
2020-04-06,OH,4450,43928,142,48378
2020-04-07,OH,4782,46056,167,50838
2020-04-08,OH,5148,48193,193,53341
2020-04-09,OH,5512,50473,213,55985
2020-04-10,OH,5878,52695,231,58573
2020-04-11,OH,6250,54221,247,60471
2020-04-12,OH,6604,56639,253,63243
2020-04-13,OH,6975,58137,274,65112
2020-04-14,OH,7280,60721,324,68001
2020-04-15,OH,7791,63761,361,71552
2020-04-16,OH,8414,66426,389,74840
2020-04-17,OH,9107,68819,418,77926
2020-04-18,OH,10222,68819,451,79041
2020-04-19,OH,11602,75697,471,87299
2020-04-20,OH,12919,77920,509,90839
2020-04-21,OH,13725,80989,557,94714
2020-04-22,OH,14117,84389,610,98506
2020-04-23,OH,14694,88183,656,102877
2020-04-24,OH,15169,92528,690,107697
2020-04-25,OH,15587,96396,711,111983
2020-04-26,OH,15963,100423,728,116386
2020-04-27,OH,16325,103692,753,120017
2020-04-28,OH,16769,106578,799,123347
2020-04-29,OH,17303,111605,937,128908
2020-04-30,OH,18027,115863,975,133890
2020-05-01,OH,18743,121763,1002,140506
2020-05-02,OH,19335,126484,1021,145819
2020-05-03,OH,19914,130252,1038,150166
2020-05-04,OH,20474,134681,1056,155155
2020-05-05,OH,20969,139766,1135,160735
2020-05-06,OH,21576,147353,1225,168929
2020-05-07,OH,22131,153928,1271,176059
2020-05-08,OH,23016,161300,1306,184316
2020-05-09,OH,23697,172973,1331,196670
2020-05-10,OH,24081,180781,1341,204862
2020-05-11,OH,24777,185753,1357,210530
2020-05-12,OH,25250,192481,1436,217731
2020-05-13,OH,25721,200133,1483,225854
2020-05-14,OH,26357,206995,1534,233352
2020-05-15,OH,26954,219228,1581,246182
2020-05-16,OH,27474,219228,1610,246702
2020-05-17,OH,27923,236539,1625,264462
2020-05-18,OH,28454,243395,1657,271849
2020-05-19,OH,28952,248650,1720,277602
2020-05-20,OH,29436,260092,1781,289528
2020-05-21,OH,30167,268911,1836,299078
2020-05-22,OH,30794,277006,1872,307800
2020-05-23,OH,31408,285086,1956,316494
2020-05-24,OH,31911,292642,1969,324553
2020-05-25,OH,32477,297857,1987,330334
2020-05-26,OH,33006,306394,2002,339400
2020-05-27,OH,33439,316286,2044,349725
2020-05-28,OH,33915,326097,2098,360012
2020-05-29,OH,34566,335324,2131,369890
2020-05-30,OH,35034,346913,2149,381947
2020-05-31,OH,35513,355395,2155,390908
2020-06-01,OH,35984,362082,2206,398066
2020-06-02,OH,36350,373558,2258,409908
2020-06-03,OH,36792,389313,2299,426105
2020-06-04,OH,37282,399969,2339,437251
2020-06-05,OH,37758,408437,2355,446195
2020-06-06,OH,38111,420415,2370,458526
2020-06-07,OH,38476,430548,2377,469024
2020-06-08,OH,38837,437981,2404,476818
2020-06-09,OH,39162,451228,2421,490390
2020-06-10,OH,39575,462309,2457,501884
2020-06-11,OH,40004,472579,2490,512583
2020-06-12,OH,40424,483294,2508,523718
2020-06-13,OH,40848,498050,2554,538898
2020-06-14,OH,41148,505072,2557,546220
2020-06-15,OH,41576,515592,2573,557168
2020-06-16,OH,42010,526123,2597,568133
2020-06-17,OH,42422,542141,2611,584563
2020-06-18,OH,43122,556902,2633,600024
2020-06-19,OH,43731,572305,2667,616036
2020-06-20,OH,44262,585703,2697,629965
2020-06-21,OH,44808,598413,2700,643221
2020-06-22,OH,45537,614064,2704,659601
2020-06-23,OH,46127,624310,2735,670437
2020-06-24,OH,46759,633928,2755,680687
2020-06-25,OH,47651,651979,2772,699630
2020-06-26,OH,48638,672914,2788,721552
2020-06-27,OH,49455,695384,2804,744839
2020-06-28,OH,50309,706456,2807,756765
2020-06-29,OH,51046,723336,2818,774382
2020-06-30,OH,51789,736140,2863,787929
2020-07-01,OH,52865,739140,2876,792005
2020-07-02,OH,54166,739140,2903,793306
2020-07-03,OH,55257,772900,2903,828157
2020-07-04,OH,56183,792187,2907,848370
2020-07-05,OH,57151,811611,2911,868762
2020-07-06,OH,57956,823456,2927,881412
2020-07-07,OH,58904,837581,2970,896485
2020-07-08,OH,60181,855071,2991,915252
2020-07-09,OH,61331,855071,3006,916402
2020-07-10,OH,62856,896697,3032,959553
2020-07-11,OH,64214,918821,3036,983035
2020-07-12,OH,65592,940794,3058,1006386
2020-07-13,OH,66853,957898,3064,1024751
2020-07-14,OH,67995,975754,3069,1043749
2020-07-15,OH,69311,993312,3075,1062623
2020-07-16,OH,70601,1018192,3103,1088793
2020-07-17,OH,72280,1043844,3112,1116124
2020-07-18,OH,73822,1064614,3132,1138436
2020-07-19,OH,74932,1087982,3174,1162914
2020-07-20,OH,76168,1105744,3189,1181912
2020-07-21,OH,77215,1122808,3219,1200023
2020-07-22,OH,78742,1142853,3235,1221595
2020-07-23,OH,80186,1164840,3256,1245026
2020-03-07,OK,1,0,0,1
2020-03-08,OK,1,8,0,9
2020-03-09,OK,1,8,0,9
2020-03-10,OK,2,15,0,17
2020-03-11,OK,2,15,0,17
2020-03-12,OK,3,36,0,39
2020-03-13,OK,3,36,0,39
2020-03-14,OK,4,36,0,40
2020-03-15,OK,9,118,0,127
2020-03-16,OK,10,174,0,184
2020-03-17,OK,17,247,0,264
2020-03-18,OK,29,378,0,407
2020-03-19,OK,44,466,1,510
2020-03-20,OK,49,538,1,587
2020-03-21,OK,53,560,1,613
2020-03-22,OK,67,669,2,736
2020-03-23,OK,81,694,2,775
2020-03-24,OK,106,735,3,841
2020-03-25,OK,164,805,5,969
2020-03-26,OK,248,958,7,1206
2020-03-27,OK,322,1084,8,1406
2020-03-28,OK,377,1180,15,1557
2020-03-29,OK,429,1205,16,1634
2020-03-30,OK,481,1207,17,1688
2020-03-31,OK,565,1229,23,1794
2020-04-01,OK,719,1248,30,1967
2020-04-02,OK,879,1265,34,2144
2020-04-03,OK,988,1315,38,2303
2020-04-04,OK,1159,1362,42,2521
2020-04-05,OK,1252,1401,46,2653
2020-04-06,OK,1327,1422,51,2749
2020-04-07,OK,1472,11821,67,13293
2020-04-08,OK,1524,11821,79,13345
2020-04-09,OK,1684,18595,80,20279
2020-04-10,OK,1794,20370,88,22164
2020-04-11,OK,1868,20790,94,22658
2020-04-12,OK,1970,20790,96,22760
2020-04-13,OK,2069,20790,99,22859
2020-04-14,OK,2184,26085,108,28269
2020-04-15,OK,2263,26956,123,29219
2020-04-16,OK,2357,28542,131,30899
2020-04-17,OK,2465,31155,136,33620
2020-04-18,OK,2570,32966,139,35536
2020-04-19,OK,2599,32966,140,35565
2020-04-20,OK,2680,32966,143,35646
2020-04-21,OK,2807,41537,164,44344
2020-04-22,OK,2894,43019,170,45913
2020-04-23,OK,3017,43019,179,46036
2020-04-24,OK,3121,43019,188,46140
2020-04-25,OK,3193,49891,194,53084
2020-04-26,OK,3253,49891,195,53144
2020-04-27,OK,3280,49891,197,53171
2020-04-28,OK,3410,56289,207,59699
2020-04-29,OK,3473,57794,214,61267
2020-04-30,OK,3618,59804,222,63422
2020-05-01,OK,3748,59804,230,63552
2020-05-02,OK,3851,59804,238,63655
2020-05-03,OK,3972,59804,238,63776
2020-05-04,OK,4044,59804,238,63848
2020-05-05,OK,4127,75290,247,79417
2020-05-06,OK,4201,78689,253,82890
2020-05-07,OK,4330,82557,260,86887
2020-05-08,OK,4424,85433,266,89857
2020-05-09,OK,4490,91379,270,95869
2020-05-10,OK,4589,91379,272,95968
2020-05-11,OK,4613,91379,274,95992
2020-05-12,OK,4732,91379,278,96111
2020-05-13,OK,4852,104275,278,109127
2020-05-14,OK,4962,107221,284,112183
2020-05-15,OK,5086,113106,285,118192
2020-05-16,OK,5237,118162,288,123399
2020-05-17,OK,5310,118162,288,123472
2020-05-18,OK,5398,118162,288,123560
2020-05-19,OK,5489,133658,294,139147
2020-05-20,OK,5532,138839,299,144371
2020-05-21,OK,5680,143915,304,149595
2020-05-22,OK,5849,147318,307,153167
2020-05-23,OK,5960,154943,311,160903
2020-05-24,OK,6037,154943,311,160980
2020-05-25,OK,6090,154943,313,161033
2020-05-26,OK,6137,153804,318,159941
2020-05-27,OK,6229,172409,322,178638
2020-05-28,OK,6270,176136,326,182406
2020-05-29,OK,6338,181060,329,187398
2020-05-30,OK,6418,186700,334,193118
2020-05-31,OK,6506,186700,334,193206
2020-06-01,OK,6573,186700,334,193273
2020-06-02,OK,6692,197965,339,204657
2020-06-03,OK,6805,201247,341,208052
2020-06-04,OK,6907,204815,344,211722
2020-06-05,OK,6907,209564,344,216471
2020-06-06,OK,7003,214598,345,221601
2020-06-07,OK,7150,214598,348,221748
2020-06-08,OK,7205,214598,348,221803
2020-06-09,OK,7363,226678,353,234041
2020-06-10,OK,7480,229817,355,237297
2020-06-11,OK,7626,233819,357,241445
2020-06-12,OK,7848,238366,359,246214
2020-06-13,OK,8073,238366,359,246439
2020-06-14,OK,8231,242587,359,250818
2020-06-15,OK,8417,242587,359,251004
2020-06-16,OK,8645,253160,363,261805
2020-06-17,OK,8904,256528,364,265432
2020-06-18,OK,9354,260199,366,269553
2020-06-19,OK,9706,264872,367,274578
2020-06-20,OK,10037,271925,368,281962
2020-06-21,OK,10515,271925,369,282440
2020-06-22,OK,10733,271925,369,282658
2020-06-23,OK,11028,284029,371,295057
2020-06-24,OK,11510,286768,372,298278
2020-06-25,OK,11948,293017,375,304965
2020-06-26,OK,12343,298434,377,310777
2020-06-27,OK,12642,313021,384,325663
2020-06-28,OK,12944,313021,385,325965
2020-06-29,OK,13172,313021,385,326193
2020-06-30,OK,13757,327840,387,341597
2020-07-01,OK,14112,332201,389,346313
2020-07-02,OK,14539,338511,395,353050
2020-07-03,OK,15065,348789,398,363854
2020-07-04,OK,15645,348789,398,364434
2020-07-05,OK,15928,348789,398,364717
2020-07-06,OK,16362,348789,399,365151
2020-07-07,OK,17220,371798,404,389018
2020-07-08,OK,17893,376930,407,394823
2020-07-09,OK,18496,383258,410,401754
2020-07-10,OK,19092,391982,416,411074
2020-07-11,OK,19779,400037,421,419816
2020-07-12,OK,20235,400037,422,420272
2020-07-13,OK,20745,400037,424,420782
2020-07-14,OK,21738,419556,428,441294
2020-07-15,OK,22813,424512,432,447325
2020-07-16,OK,23441,433376,438,456817
2020-07-17,OK,24140,440904,445,465044
2020-07-18,OK,25056,450675,451,475731
2020-07-19,OK,25265,450675,451,475940
2020-07-20,OK,25433,450675,452,476108
2020-07-21,OK,26326,472057,461,498383
2020-07-22,OK,27301,478297,474,505598
2020-07-23,OK,27969,485206,477,513175
2020-03-04,OR,3,29,0,32
2020-03-05,OR,3,45,0,48
2020-03-06,OR,3,64,0,67
2020-03-07,OR,7,77,0,84
2020-03-08,OR,14,100,0,114
2020-03-09,OR,14,165,0,179
2020-03-10,OR,15,213,0,228
2020-03-11,OR,19,286,0,305
2020-03-12,OR,19,286,0,305
2020-03-13,OR,30,337,0,367
2020-03-14,OR,30,337,0,367
2020-03-15,OR,36,420,0,456
2020-03-16,OR,39,579,0,618
2020-03-17,OR,47,689,0,736
2020-03-18,OR,75,1118,3,1193
2020-03-19,OR,88,1329,3,1417
2020-03-20,OR,114,2003,3,2117
2020-03-21,OR,114,2003,3,2117
2020-03-22,OR,161,2864,4,3025
2020-03-23,OR,191,3649,5,3840
2020-03-24,OR,209,4350,8,4559
2020-03-25,OR,209,4350,8,4559
2020-03-26,OR,327,6953,11,7280
2020-03-27,OR,414,8510,12,8924
2020-03-28,OR,479,9693,13,10172
2020-03-29,OR,548,10878,13,11426
2020-03-30,OR,606,12277,16,12883
2020-03-31,OR,690,13136,18,13826
2020-04-01,OR,736,13136,18,13872
2020-04-02,OR,826,15259,21,16085
2020-04-03,OR,899,16535,22,17434
2020-04-04,OR,999,16535,26,17534
2020-04-05,OR,1068,19556,27,20624
2020-04-06,OR,1132,20669,27,21801
2020-04-07,OR,1181,21826,33,23007
2020-04-08,OR,1239,23325,33,24564
2020-04-09,OR,1321,24306,44,25627
2020-04-10,OR,1321,24306,44,25627
2020-04-11,OR,1371,25853,48,27224
2020-04-12,OR,1527,28231,52,29758
2020-04-13,OR,1584,29537,53,31121
2020-04-14,OR,1633,30730,55,32363
2020-04-15,OR,1663,31688,58,33351
2020-04-16,OR,1736,33202,64,34938
2020-04-17,OR,1785,34536,70,36321
2020-04-18,OR,1844,35739,72,37583
2020-04-19,OR,1910,37128,74,39038
2020-04-20,OR,1956,38089,75,40045
2020-04-21,OR,2002,39126,78,41128
2020-04-22,OR,2059,39126,78,41185
2020-04-23,OR,2127,41849,83,43976
2020-04-24,OR,2177,43315,86,45492
2020-04-25,OR,2253,45124,87,47377
2020-04-26,OR,2311,46653,91,48964
2020-04-27,OR,2354,48844,92,51198
2020-04-28,OR,2354,48844,92,51198
2020-04-29,OR,2446,52026,101,54472
2020-04-30,OR,2510,53522,103,56032
2020-05-01,OR,2579,55597,104,58176
2020-05-02,OR,2635,57501,109,60136
2020-05-03,OR,2680,59374,109,62054
2020-05-04,OR,2759,60698,109,63457
2020-05-05,OR,2839,62585,113,65424
2020-05-06,OR,2916,65060,115,67976
2020-05-07,OR,2989,67469,121,70458
2020-05-08,OR,3068,69625,124,72693
2020-05-09,OR,3160,71460,127,74620
2020-05-10,OR,3228,72279,127,75507
2020-05-11,OR,3286,74320,130,77606
2020-05-12,OR,3286,74320,130,77606
2020-05-13,OR,3416,80571,134,83987
2020-05-14,OR,3479,80571,137,84050
2020-05-15,OR,3541,85965,137,89506
2020-05-16,OR,3612,88587,137,92199
2020-05-17,OR,3623,90733,137,94356
2020-05-18,OR,3687,93628,138,97315
2020-05-19,OR,3726,95994,140,99720
2020-05-20,OR,3801,98348,144,102149
2020-05-21,OR,3817,101407,145,105224
2020-05-22,OR,3864,103975,147,107839
2020-05-23,OR,3888,106319,147,110207
2020-05-24,OR,3927,108268,148,112195
2020-05-25,OR,3949,109909,148,113858
2020-05-26,OR,3967,111571,148,115538
2020-05-27,OR,4038,112954,148,116992
2020-05-28,OR,4086,115561,151,119647
2020-05-29,OR,4131,118550,151,122681
2020-05-30,OR,4185,122610,153,126795
2020-05-31,OR,4243,124958,153,129201
2020-06-01,OR,4302,127316,154,131618
2020-06-02,OR,4335,129874,157,134209
2020-06-03,OR,4399,132269,159,136668
2020-06-04,OR,4474,134838,159,139312
2020-06-05,OR,4570,138676,161,143246
2020-06-06,OR,4662,141497,163,146159
2020-06-07,OR,4808,143592,164,148400
2020-06-08,OR,4922,144957,164,149879
2020-06-09,OR,4988,148629,169,153617
2020-06-10,OR,5060,151698,169,156758
2020-06-11,OR,5237,156567,171,161804
2020-06-12,OR,5377,160812,173,166189
2020-06-13,OR,5535,164944,174,170479
2020-06-14,OR,5636,168246,176,173882
2020-06-15,OR,5820,170316,180,176136
2020-06-16,OR,6098,173440,182,179538
2020-06-17,OR,6218,178132,183,184350
2020-06-18,OR,6366,182770,187,189136
2020-06-19,OR,6572,187345,188,193917
2020-06-20,OR,6750,187345,189,194095
2020-06-21,OR,6937,195674,190,202611
2020-06-22,OR,7083,199545,192,206628
2020-06-23,OR,7274,203438,192,210712
2020-06-24,OR,7444,206564,195,214008
2020-06-25,OR,7568,209050,197,216618
2020-06-26,OR,7818,209050,202,216868
2020-06-27,OR,8094,219529,202,227623
2020-06-28,OR,8341,219529,202,227870
2020-06-29,OR,8485,226648,204,235133
2020-06-30,OR,8656,228978,207,237634
2020-07-01,OR,8931,234429,208,243360
2020-07-02,OR,9294,241760,209,251054
2020-07-03,OR,9636,245096,209,254732
2020-07-04,OR,9930,245096,213,255026
2020-07-05,OR,10230,253971,215,264201
2020-07-06,OR,10395,257326,215,267721
2020-07-07,OR,10605,261301,220,271906
2020-07-08,OR,10817,265450,224,276267
2020-07-09,OR,11188,270887,230,282075
2020-07-10,OR,11454,275316,232,286770
2020-07-11,OR,11851,280332,232,292183
2020-07-12,OR,12170,284002,234,296172
2020-07-13,OR,12438,288274,237,300712
2020-07-14,OR,12805,292651,244,305456
2020-07-15,OR,13081,298705,247,311786
2020-07-16,OR,13509,305437,249,318946
2020-07-17,OR,13802,310393,254,324195
2020-07-18,OR,14149,316644,257,330793
2020-07-19,OR,14579,321011,260,335590
2020-07-20,OR,14847,325197,262,340044
2020-07-21,OR,15139,330124,269,345263
2020-07-22,OR,15393,337401,269,352794
2020-07-23,OR,15713,342778,273,358491
2020-03-06,PA,2,0,0,2
2020-03-07,PA,4,0,0,4
2020-03-08,PA,6,0,0,6
2020-03-09,PA,10,0,0,10
2020-03-10,PA,12,0,0,12
2020-03-11,PA,16,88,0,104
2020-03-12,PA,22,116,0,138
2020-03-13,PA,41,140,0,181
2020-03-14,PA,47,205,0,252
2020-03-15,PA,63,205,0,268
2020-03-16,PA,76,670,0,746
2020-03-17,PA,96,879,0,975
2020-03-18,PA,133,1187,1,1320
2020-03-19,PA,185,1608,1,1793
2020-03-20,PA,268,2574,1,2842
2020-03-21,PA,371,3766,2,4137
2020-03-22,PA,479,4964,2,5443
2020-03-23,PA,644,6595,6,7239
2020-03-24,PA,851,8643,7,9494
2020-03-25,PA,1127,11193,11,12320
2020-03-26,PA,1687,16441,16,18128
2020-03-27,PA,2218,21016,22,23234
2020-03-28,PA,2751,25254,34,28005
2020-03-29,PA,3394,30061,38,33455
2020-03-30,PA,4087,33777,49,37864
2020-03-31,PA,4843,37645,63,42488
2020-04-01,PA,5805,42427,74,48232
2020-04-02,PA,7016,47698,90,54714
2020-04-03,PA,8420,53695,102,62115
2020-04-04,PA,10017,60013,136,70030
2020-04-05,PA,11510,66261,150,77771
2020-04-06,PA,12980,70874,162,83854
2020-04-07,PA,14559,76719,240,91278
2020-04-08,PA,16239,82299,309,98538
2020-04-09,PA,18228,87374,338,105602
2020-04-10,PA,19979,93040,416,113019
2020-04-11,PA,21655,98498,494,120153
2020-04-12,PA,22833,102057,507,124890
2020-04-13,PA,24199,105593,524,129792
2020-04-14,PA,25345,108286,584,133631
2020-04-15,PA,26490,111094,647,137584
2020-04-16,PA,27735,113735,707,141470
2020-04-17,PA,29441,117932,756,147373
2020-04-18,PA,31069,122896,836,153965
2020-04-19,PA,32284,126570,1112,158854
2020-04-20,PA,33232,129720,1204,162952
2020-04-21,PA,34528,132323,1564,166851
2020-04-22,PA,35684,136272,1622,171956
2020-04-23,PA,37053,142061,1421,179114
2020-04-24,PA,38652,147491,1492,186143
2020-04-25,PA,40049,152886,1537,192935
2020-04-26,PA,41165,157428,1550,198593
2020-04-27,PA,42050,161372,1597,203422
2020-04-28,PA,43264,165824,1716,209088
2020-04-29,PA,44366,170517,2195,214883
2020-04-30,PA,45763,175602,2292,221365
2020-05-01,PA,46971,180477,2354,227448
2020-05-02,PA,48305,187071,2418,235376
2020-05-03,PA,49267,191374,2444,240641
2020-05-04,PA,50092,195498,2458,245590
2020-05-05,PA,50957,199925,3012,250882
2020-05-06,PA,51845,204495,3106,256340
2020-05-07,PA,52915,209873,3416,262788
2020-05-08,PA,54238,216321,3616,270559
2020-05-09,PA,55316,221791,3688,277107
2020-05-10,PA,56611,227772,3707,284383
2020-05-11,PA,57154,231704,3731,288858
2020-05-12,PA,57991,237989,3806,295980
2020-05-13,PA,58698,244171,3943,302869
2020-05-14,PA,59636,251559,4218,311195
2020-05-15,PA,60622,259210,4342,319832
2020-05-16,PA,61611,266225,4403,327836
2020-05-17,PA,62234,270670,4418,332904
2020-05-18,PA,63056,277553,4505,340609
2020-05-19,PA,63666,286034,4624,349700
2020-05-20,PA,63666,286034,4624,349700
2020-05-21,PA,65392,303514,4869,368906
2020-05-22,PA,66258,312743,4984,379001
2020-05-23,PA,66983,321469,5096,388452
2020-05-24,PA,67713,328382,5124,396095
2020-05-25,PA,68186,334928,5139,403114
2020-05-26,PA,68637,339835,5152,408472
2020-05-27,PA,69417,349990,5265,419407
2020-05-28,PA,70042,357804,5373,427846
2020-05-29,PA,71339,366970,5464,438309
2020-05-30,PA,72031,375741,5537,447772
2020-05-31,PA,72546,383111,5555,455657
2020-06-01,PA,72898,389431,5567,462329
2020-06-02,PA,73510,399361,5667,472871
2020-06-03,PA,74022,401369,5741,475391
2020-06-04,PA,74560,416942,5817,491502
2020-06-05,PA,75005,424201,5886,499206
2020-06-06,PA,75706,435122,5931,510828
2020-06-07,PA,76212,444173,5943,520385
2020-06-08,PA,76563,451387,5953,527950
2020-06-09,PA,77056,459248,6014,536304
2020-06-10,PA,77466,466964,6062,544430
2020-06-11,PA,77933,476439,6113,554372
2020-06-12,PA,77999,488385,6162,566384
2020-06-13,PA,78462,496589,6211,575051
2020-06-14,PA,78798,504435,6215,583233
2020-06-15,PA,79121,513909,6243,593030
2020-06-16,PA,79483,523609,6276,603092
2020-06-17,PA,79818,533013,6319,612831
2020-06-18,PA,80236,543832,6361,624068
2020-06-19,PA,80762,556456,6399,637218
2020-06-20,PA,81266,566461,6419,647727
2020-06-21,PA,81730,576015,6423,657745
2020-06-22,PA,82186,585662,6426,667848
2020-06-23,PA,82696,596407,6464,679103
2020-06-24,PA,83191,608217,6518,691408
2020-06-25,PA,83770,621031,6557,704801
2020-06-26,PA,84370,634711,6579,719081
2020-06-27,PA,84370,634711,6579,719081
2020-06-28,PA,85496,657486,6579,742982
2020-06-29,PA,85988,666901,6614,752889
2020-06-30,PA,86606,677581,6649,764187
2020-07-01,PA,87242,689562,6649,776804
2020-07-02,PA,88074,702199,6712,790273
2020-07-03,PA,88741,715403,6746,804144
2020-07-04,PA,89375,725448,6749,814823
2020-07-05,PA,89854,734846,6753,824700
2020-07-06,PA,90304,743020,6754,833324
2020-07-07,PA,91299,758803,6787,850102
2020-07-08,PA,92148,774378,6812,866526
2020-07-09,PA,92867,787156,6848,880023
2020-07-10,PA,93876,804764,6880,898640
2020-07-11,PA,94689,817634,6897,912323
2020-07-12,PA,95266,829018,6904,924284
2020-07-13,PA,95742,835732,6911,931474
2020-07-14,PA,96671,850612,6931,947283
2020-07-15,PA,97665,870984,6957,968649
2020-07-16,PA,98446,885195,6973,983641
2020-07-17,PA,99478,899912,6992,999390
2020-07-18,PA,100241,912486,7007,1012727
2020-07-19,PA,101027,926352,7015,1027379
2020-07-20,PA,101738,938175,7018,1039913
2020-07-21,PA,102765,952998,7038,1055763
2020-07-22,PA,103396,968081,7063,1071477
2020-07-23,PA,104358,981259,7079,1085617
2020-03-16,PR,5,9,0,14
2020-03-17,PR,5,13,0,18
2020-03-18,PR,5,31,0,36
2020-03-19,PR,5,56,0,61
2020-03-20,PR,14,114,0,128
2020-03-21,PR,21,143,0,164
2020-03-22,PR,23,183,1,206
2020-03-23,PR,31,189,2,220
2020-03-24,PR,39,268,2,307
2020-03-25,PR,51,317,2,368
2020-03-26,PR,64,377,2,441
2020-03-27,PR,79,519,3,598
2020-03-28,PR,100,739,3,839
2020-03-29,PR,127,841,5,968
2020-03-30,PR,174,931,6,1105
2020-03-31,PR,239,1195,8,1434
2020-04-01,PR,286,1409,11,1695
2020-04-02,PR,316,1604,12,1920
2020-04-03,PR,378,2049,15,2427
2020-04-04,PR,452,2605,18,3057
2020-04-05,PR,475,3073,20,3548
2020-04-06,PR,513,3432,21,3945
2020-04-07,PR,573,3966,23,4539
2020-04-08,PR,620,4266,24,4886
2020-04-09,PR,683,4703,33,5386
2020-04-10,PR,725,5121,39,5846
2020-04-11,PR,788,5583,42,6371
2020-04-12,PR,897,5819,44,6716
2020-04-13,PR,903,5960,45,6863
2020-04-14,PR,923,6284,45,7207
2020-04-15,PR,974,6825,51,7799
2020-04-16,PR,1043,7315,56,8358
2020-04-17,PR,1068,7864,58,8932
2020-04-18,PR,1118,8055,60,9173
2020-04-19,PR,1213,8280,62,9493
2020-04-20,PR,1252,8486,63,9738
2020-04-21,PR,1298,8789,64,10087
2020-04-22,PR,915,8842,67,9757
2020-04-23,PR,915,9313,69,10228
2020-04-24,PR,1276,9313,77,10589
2020-04-25,PR,1307,9313,83,10620
2020-04-26,PR,1371,9313,84,10684
2020-04-27,PR,1389,9313,84,10702
2020-04-28,PR,1400,9313,86,10713
2020-04-29,PR,1433,9313,86,10746
2020-04-30,PR,1539,9313,92,10852
2020-05-01,PR,1575,9313,92,10888
2020-05-02,PR,1757,9313,95,11070
2020-05-03,PR,1808,9313,97,11121
2020-05-04,PR,1843,9313,97,11156
2020-05-05,PR,1924,9313,99,11237
2020-05-06,PR,1968,0,99,1968
2020-05-07,PR,2031,0,102,2031
2020-05-08,PR,2156,0,107,2156
2020-05-09,PR,2173,0,108,2173
2020-05-10,PR,2198,0,111,2198
2020-05-11,PR,2256,0,113,2256
2020-05-12,PR,2299,0,114,2299
2020-05-13,PR,2329,0,115,2329
2020-05-14,PR,2427,0,117,2427
2020-05-15,PR,2542,0,122,2542
2020-05-16,PR,2589,0,122,2589
2020-05-17,PR,2646,0,123,2646
2020-05-18,PR,2710,0,124,2710
2020-05-19,PR,2805,0,124,2805
2020-05-20,PR,2866,0,125,2866
2020-05-21,PR,2913,40488,126,43401
2020-05-22,PR,3030,40488,126,43518
2020-05-23,PR,3100,40488,127,43588
2020-05-24,PR,3189,40488,127,43677
2020-05-25,PR,3260,40488,129,43748
2020-05-26,PR,3324,40488,129,43812
2020-05-27,PR,3397,40488,129,43885
2020-05-28,PR,3486,60422,131,63908
2020-05-29,PR,3647,60422,132,64069
2020-05-30,PR,3718,60422,133,64140
2020-05-31,PR,3776,60422,136,64198
2020-06-01,PR,3873,60422,136,64295
2020-06-02,PR,3935,60422,138,64357
2020-06-03,PR,4023,60422,140,64445
2020-06-04,PR,4508,60422,140,64930
2020-06-05,PR,4620,60422,141,65042
2020-06-06,PR,4915,88685,142,93600
2020-06-07,PR,4985,88685,142,93670
2020-06-08,PR,5046,88685,142,93731
2020-06-09,PR,5185,88685,142,93870
2020-06-10,PR,5329,88685,143,94014
2020-06-11,PR,5352,88685,144,94037
2020-06-12,PR,5536,113280,146,118816
2020-06-13,PR,5690,113280,146,118970
2020-06-14,PR,5811,113280,147,119091
2020-06-15,PR,5890,113280,147,119170
2020-06-16,PR,5951,113280,147,119231
2020-06-17,PR,6003,113280,147,119283
2020-06-18,PR,6111,113280,147,119391
2020-06-19,PR,6195,113280,147,119475
2020-06-20,PR,6463,113280,147,119743
2020-06-21,PR,6525,113280,149,119805
2020-06-22,PR,6564,113280,149,119844
2020-06-23,PR,6685,113280,149,119965
2020-06-24,PR,6820,113280,149,120100
2020-06-25,PR,6877,113280,151,120157
2020-06-26,PR,6922,113280,151,120202
2020-06-27,PR,7066,113280,152,120346
2020-06-28,PR,7189,113280,153,120469
2020-06-29,PR,7250,192686,153,199936
2020-06-30,PR,7465,192686,153,200151
2020-07-01,PR,7537,192686,153,200223
2020-07-02,PR,7608,192686,153,200294
2020-07-03,PR,7683,192686,154,200369
2020-07-04,PR,7787,192686,155,200473
2020-07-05,PR,7916,192686,155,200602
2020-07-06,PR,8585,192686,155,201271
2020-07-07,PR,8714,192686,157,201400
2020-07-08,PR,8745,192686,159,201431
2020-07-09,PR,8862,255766,159,264628
2020-07-10,PR,9137,255766,159,264903
2020-07-11,PR,9366,192686,167,202052
2020-07-12,PR,9654,192686,167,202340
2020-07-13,PR,10010,192686,167,202696
2020-07-14,PR,10123,192686,169,202809
2020-07-15,PR,10379,192686,171,203065
2020-07-16,PR,10574,192686,172,203260
2020-07-17,PR,11120,192686,177,203806
2020-07-18,PR,11453,192686,178,204139
2020-07-19,PR,12063,192686,178,204749
2020-07-20,PR,12461,192686,180,205147
2020-07-21,PR,12940,192686,180,205626
2020-07-22,PR,13038,192686,185,205724
2020-07-23,PR,13473,192686,188,206159
2020-03-01,RI,2,2,0,4
2020-03-02,RI,2,3,0,5
2020-03-03,RI,2,5,0,7
2020-03-04,RI,2,15,0,17
2020-03-05,RI,3,19,0,22
2020-03-06,RI,3,30,0,33
2020-03-07,RI,3,49,0,52
2020-03-08,RI,3,67,0,70
2020-03-09,RI,4,82,0,86
2020-03-10,RI,5,105,0,110
2020-03-11,RI,5,139,0,144
2020-03-12,RI,13,176,0,189
2020-03-13,RI,19,224,0,243
2020-03-14,RI,19,310,0,329
2020-03-15,RI,20,364,0,384
2020-03-16,RI,22,455,0,477
2020-03-17,RI,33,608,0,641
2020-03-18,RI,44,719,0,763
2020-03-19,RI,61,968,0,1029
2020-03-20,RI,74,1161,0,1235
2020-03-21,RI,88,1284,0,1372
2020-03-22,RI,113,1547,0,1660
2020-03-23,RI,129,1713,0,1842
2020-03-24,RI,148,1951,0,2099
2020-03-25,RI,176,2124,0,2300
2020-03-26,RI,217,2300,0,2517
2020-03-27,RI,248,2502,0,2750
2020-03-28,RI,312,2742,0,3054
2020-03-29,RI,417,3056,3,3473
2020-03-30,RI,495,3246,4,3741
2020-03-31,RI,568,3544,8,4112
2020-04-01,RI,668,4189,10,4857
2020-04-02,RI,730,4625,12,5355
2020-04-03,RI,831,5342,14,6173
2020-04-04,RI,968,5962,17,6930
2020-04-05,RI,1150,7032,25,8182
2020-04-06,RI,1356,8609,27,9965
2020-04-07,RI,1617,10095,30,11712
2020-04-08,RI,1890,11667,35,13557
2020-04-09,RI,2169,13029,43,15198
2020-04-10,RI,2573,15403,49,17976
2020-04-11,RI,2853,17130,56,19983
2020-04-12,RI,3142,18578,63,21720
2020-04-13,RI,3329,19431,73,22760
2020-04-14,RI,3596,20990,80,24586
2020-04-15,RI,3903,22567,87,26470
2020-04-16,RI,4295,24657,105,28952
2020-04-17,RI,4585,26157,118,30742
2020-04-18,RI,4868,27527,150,32395
2020-04-19,RI,5207,29289,164,34496
2020-04-20,RI,5585,30883,175,36468
2020-04-21,RI,5972,32606,186,38578
2020-04-22,RI,6354,34528,201,40882
2020-04-23,RI,6773,36423,213,43196
2020-04-24,RI,7188,39071,202,46259
2020-04-25,RI,7493,40860,215,48353
2020-04-26,RI,7769,42746,226,50515
2020-04-27,RI,7972,43915,233,51887
2020-04-28,RI,8296,45689,239,53985
2020-04-29,RI,8668,48143,251,56811
2020-04-30,RI,9016,50100,266,59116
2020-05-01,RI,9333,52328,279,61661
2020-05-02,RI,9522,53623,296,63145
2020-05-03,RI,9703,55233,320,64936
2020-05-04,RI,9994,56802,341,66796
2020-05-05,RI,10297,58781,355,69078
2020-05-06,RI,10639,60718,370,71357
2020-05-07,RI,10910,62647,388,73557
2020-05-08,RI,11141,64338,399,75479
2020-05-09,RI,11427,66604,418,78031
2020-05-10,RI,11613,68106,422,79719
2020-05-11,RI,11788,69365,430,81153
2020-05-12,RI,12007,70916,444,82923
2020-05-13,RI,12203,72840,462,85043
2020-05-14,RI,12431,74767,468,87198
2020-05-15,RI,12663,76467,479,89130
2020-05-16,RI,12915,78231,489,91146
2020-05-17,RI,13040,79768,499,92808
2020-05-18,RI,13177,81057,506,94234
2020-05-19,RI,13392,82935,532,96327
2020-05-20,RI,13579,84460,538,98039
2020-05-21,RI,13748,86399,556,100147
2020-05-22,RI,13949,87850,579,101799
2020-05-23,RI,14057,89167,597,103224
2020-05-24,RI,14141,89924,608,104065
2020-05-25,RI,14211,90674,608,104885
2020-05-26,RI,14365,92400,634,106765
2020-05-27,RI,14498,93504,655,108002
2020-05-28,RI,14630,94575,677,109205
2020-05-29,RI,14808,96112,693,110920
2020-05-30,RI,14912,97940,711,112852
2020-05-31,RI,14988,98790,718,113778
2020-06-01,RI,15087,100112,720,115199
2020-06-02,RI,15194,101512,732,116706
2020-06-03,RI,15299,103136,742,118435
2020-06-04,RI,15416,105136,756,120552
2020-06-05,RI,15521,106656,772,122177
2020-06-06,RI,15589,107782,772,123371
2020-06-07,RI,15638,108540,772,124178
2020-06-08,RI,15683,109424,799,125107
2020-06-09,RI,15751,110588,808,126339
2020-06-10,RI,15855,111952,812,127807
2020-06-11,RI,15942,113390,823,129332
2020-06-12,RI,16023,115483,833,131506
2020-06-13,RI,16072,116709,833,132781
2020-06-14,RI,16104,117593,833,133697
2020-06-15,RI,16180,119304,851,135484
2020-06-16,RI,16232,120790,865,137022
2020-06-17,RI,16283,121997,876,138280
2020-06-18,RI,16354,123216,885,139570
2020-06-19,RI,16413,124397,894,140810
2020-06-20,RI,16449,125078,894,141527
2020-06-21,RI,16476,125701,894,142177
2020-06-22,RI,16535,127297,903,143832
2020-06-23,RI,16612,128896,906,145508
2020-06-24,RI,16663,130382,912,147045
2020-06-25,RI,16708,131788,920,148496
2020-06-26,RI,16777,133102,927,149879
2020-06-27,RI,16813,134300,927,151113
2020-06-28,RI,16835,134878,927,151713
2020-06-29,RI,16871,136198,946,153069
2020-06-30,RI,16911,137172,950,154083
2020-07-01,RI,16976,139063,956,156039
2020-07-02,RI,17035,140048,959,157083
2020-07-03,RI,17057,140721,960,157778
2020-07-04,RI,17084,141673,960,158757
2020-07-05,RI,17108,143047,960,160155
2020-07-06,RI,17163,144551,960,161714
2020-07-07,RI,17204,146066,969,163270
2020-07-08,RI,17204,146066,971,163270
2020-07-09,RI,17243,147894,974,165137
2020-07-10,RI,17312,149343,976,166655
2020-07-11,RI,17312,149343,976,166655
2020-07-12,RI,17312,149343,976,166655
2020-07-13,RI,17487,155756,984,173243
2020-07-14,RI,17588,157070,985,174658
2020-07-15,RI,17640,158235,987,175875
2020-07-16,RI,17711,159677,988,177388
2020-07-17,RI,17793,161408,990,179201
2020-07-18,RI,17793,161408,990,179201
2020-07-19,RI,17793,161408,990,179201
2020-07-20,RI,17904,165721,995,183625
2020-07-21,RI,17986,166978,996,184964
2020-07-22,RI,18062,168794,997,186856
2020-07-23,RI,18148,171191,1001,189339
2020-03-04,SC,0,5,0,5
2020-03-05,SC,0,5,0,5
2020-03-06,SC,0,5,0,5
2020-03-07,SC,2,8,0,10
2020-03-08,SC,2,8,0,10
2020-03-09,SC,7,24,0,31
2020-03-10,SC,7,24,0,31
2020-03-11,SC,9,32,0,41
2020-03-12,SC,10,48,0,58
2020-03-13,SC,12,75,0,87
2020-03-14,SC,13,110,0,123
2020-03-15,SC,19,154,0,173
2020-03-16,SC,28,235,1,263
2020-03-17,SC,33,311,1,344
2020-03-18,SC,60,583,1,643
2020-03-19,SC,60,583,1,643
2020-03-20,SC,81,833,1,914
2020-03-21,SC,152,1255,1,1407
2020-03-22,SC,195,1466,3,1661
2020-03-23,SC,298,1466,5,1764
2020-03-24,SC,298,2012,5,2310
2020-03-25,SC,424,2303,7,2727
2020-03-26,SC,456,2307,9,2763
2020-03-27,SC,456,2307,9,2763
2020-03-28,SC,539,2408,13,2947
2020-03-29,SC,774,3015,16,3789
2020-03-30,SC,925,4160,18,5085
2020-03-31,SC,1083,4616,22,5699
2020-04-01,SC,1293,5033,26,6326
2020-04-02,SC,1554,5441,31,6995
2020-04-03,SC,1554,5441,31,6995
2020-04-04,SC,1917,16397,40,18314
2020-04-05,SC,2049,16927,44,18976
2020-04-06,SC,2049,16927,44,18976
2020-04-07,SC,2417,21263,51,23680
2020-04-08,SC,2552,22082,63,24634
2020-04-09,SC,2792,24575,67,27367
2020-04-10,SC,3065,25118,72,28183
2020-04-11,SC,3207,26886,80,30093
2020-04-12,SC,3319,28106,82,31425
2020-04-13,SC,3319,28106,82,31425
2020-04-14,SC,3553,30319,97,33872
2020-04-15,SC,3656,31077,107,34733
2020-04-16,SC,3656,31077,107,34733
2020-04-17,SC,3931,32353,109,36284
2020-04-18,SC,4246,34587,119,38833
2020-04-19,SC,4377,36103,120,40480
2020-04-20,SC,4377,36103,120,40480
2020-04-21,SC,4439,36838,124,41277
2020-04-22,SC,4761,38350,140,43111
2020-04-23,SC,4917,39546,150,44463
2020-04-24,SC,4917,39546,150,44463
2020-04-25,SC,5253,43761,166,49014
2020-04-26,SC,5490,45271,174,50761
2020-04-27,SC,5490,45271,174,50761
2020-04-28,SC,5613,46532,177,52145
2020-04-29,SC,5881,48336,203,54217
2020-04-30,SC,6095,50417,244,56512
2020-05-01,SC,6258,53121,256,59379
2020-05-02,SC,6489,55127,267,61616
2020-05-03,SC,6626,57562,275,64188
2020-05-04,SC,6626,57562,275,64188
2020-05-05,SC,6757,61014,283,67771
2020-05-06,SC,6936,70546,305,77482
2020-05-07,SC,6936,70546,305,77482
2020-05-08,SC,7142,66300,316,73442
2020-05-09,SC,7531,73432,330,80963
2020-05-10,SC,7653,76804,331,84457
2020-05-11,SC,7653,76804,331,84457
2020-05-12,SC,7927,85213,355,93140
2020-05-13,SC,7927,85213,355,93140
2020-05-14,SC,8189,94346,371,102535
2020-05-15,SC,8407,101209,380,109616
2020-05-16,SC,8407,101209,380,109616
2020-05-17,SC,8816,111670,380,120486
2020-05-18,SC,8942,122617,391,131559
2020-05-19,SC,9056,126007,399,135063
2020-05-20,SC,9056,126007,399,135063
2020-05-21,SC,9175,129063,407,138238
2020-05-22,SC,9638,140385,419,150023
2020-05-23,SC,9895,149015,425,158910
2020-05-24,SC,10096,153851,435,163947
2020-05-25,SC,10178,155842,440,166020
2020-05-26,SC,10416,162318,446,172734
2020-05-27,SC,10623,165060,466,175683
2020-05-28,SC,10788,171461,470,182249
2020-05-29,SC,11131,177126,483,188257
2020-05-30,SC,11394,178125,487,189519
2020-05-31,SC,11861,188355,494,200216
2020-06-01,SC,12148,192540,500,204688
2020-06-02,SC,12415,206362,501,218777
2020-06-03,SC,12651,210274,518,222925
2020-06-04,SC,13005,217846,525,230851
2020-06-05,SC,13453,217846,538,231299
2020-06-06,SC,13916,218828,545,232744
2020-06-07,SC,14286,223573,546,237859
2020-06-08,SC,14800,229861,557,244661
2020-06-09,SC,15228,232754,568,247982
2020-06-10,SC,15759,236773,575,252532
2020-06-11,SC,16441,213616,588,230057
2020-06-12,SC,17170,218889,593,236059
2020-06-13,SC,17955,223951,599,241906
2020-06-14,SC,18795,229541,600,248336
2020-06-15,SC,19378,236179,602,255557
2020-06-16,SC,19990,247689,607,267679
2020-06-17,SC,20556,252198,617,272754
2020-06-18,SC,21548,258975,621,280523
2020-06-19,SC,22631,265669,639,288300
2020-06-20,SC,23786,272463,644,296249
2020-06-21,SC,24693,277974,653,302667
2020-06-22,SC,25701,278179,659,303880
2020-06-23,SC,26613,282638,673,309251
2020-06-24,SC,27897,290311,683,318208
2020-06-25,SC,29022,304336,693,333358
2020-06-26,SC,30335,304336,694,334671
2020-06-27,SC,31939,319225,711,351164
2020-06-28,SC,33320,326482,716,359802
2020-06-29,SC,34644,334661,720,369305
2020-06-30,SC,36399,344173,739,380572
2020-07-01,SC,37919,351953,766,389872
2020-07-02,SC,39701,361700,784,401401
2020-07-03,SC,41532,367500,793,409032
2020-07-04,SC,43386,377307,813,420693
2020-07-05,SC,44847,385962,820,430809
2020-07-06,SC,46380,393477,827,439857
2020-07-07,SC,47352,397939,846,445291
2020-07-08,SC,48909,404931,884,453840
2020-07-09,SC,50691,413074,905,463765
2020-07-10,SC,52419,422816,929,475235
2020-07-11,SC,54699,433391,951,488090
2020-07-12,SC,56648,435860,961,492508
2020-07-13,SC,58168,448933,972,507101
2020-07-14,SC,60389,457092,993,517481
2020-07-15,SC,62245,463738,998,525983
2020-07-16,SC,64083,475881,1070,539964
2020-07-17,SC,66060,487315,1096,553375
2020-07-18,SC,67612,494381,1135,561993
2020-07-19,SC,69986,507400,1155,577386
2020-07-20,SC,71445,516871,1164,588316
2020-07-21,SC,73337,525356,1221,598693
2020-07-22,SC,75042,534118,1285,609160
2020-07-23,SC,76606,541868,1334,618474
2020-03-07,SD,0,5,0,5
2020-03-08,SD,0,5,0,5
2020-03-09,SD,0,5,0,5
2020-03-10,SD,0,11,0,11
2020-03-11,SD,5,13,0,18
2020-03-12,SD,8,27,0,35
2020-03-13,SD,9,73,0,82
2020-03-14,SD,9,182,0,191
2020-03-15,SD,9,327,0,336
2020-03-16,SD,10,494,0,504
2020-03-17,SD,11,551,0,562
2020-03-18,SD,11,551,1,562
2020-03-19,SD,11,551,1,562
2020-03-20,SD,14,663,1,677
2020-03-21,SD,14,691,1,705
2020-03-22,SD,21,740,1,761
2020-03-23,SD,28,762,1,790
2020-03-24,SD,30,790,1,820
2020-03-25,SD,41,819,1,860
2020-03-26,SD,46,1973,1,2019
2020-03-27,SD,58,2387,1,2445
2020-03-28,SD,68,2592,1,2660
2020-03-29,SD,90,3127,1,3217
2020-03-30,SD,101,3478,1,3579
2020-03-31,SD,108,3609,1,3717
2020-04-01,SD,129,3903,2,4032
2020-04-02,SD,165,4217,2,4382
2020-04-03,SD,187,4593,2,4780
2020-04-04,SD,212,5012,2,5224
2020-04-05,SD,240,5353,2,5593
2020-04-06,SD,288,5732,4,6020
2020-04-07,SD,320,5948,6,6268
2020-04-08,SD,393,6355,6,6748
2020-04-09,SD,447,6700,6,7147
2020-04-10,SD,536,7111,6,7647
2020-04-11,SD,626,7378,6,8004
2020-04-12,SD,730,7823,6,8553
2020-04-13,SD,868,8134,6,9002
2020-04-14,SD,988,8308,6,9296
2020-04-15,SD,1168,8691,6,9859
2020-04-16,SD,1311,9239,7,10550
2020-04-17,SD,1411,9651,7,11062
2020-04-18,SD,1542,10118,7,11660
2020-04-19,SD,1635,10427,7,12062
2020-04-20,SD,1685,10641,7,12326
2020-04-21,SD,1755,11060,8,12815
2020-04-22,SD,1858,11588,8,13446
2020-04-23,SD,1956,12109,9,14065
2020-04-24,SD,2040,12784,10,14824
2020-04-25,SD,2147,13449,10,15596
2020-04-26,SD,2212,14062,11,16274
2020-04-27,SD,2245,14130,11,16375
2020-04-28,SD,2313,14299,11,16612
2020-04-29,SD,2373,14460,13,16833
2020-04-30,SD,2449,14579,17,17028
2020-05-01,SD,2525,14838,21,17363
2020-05-02,SD,2588,15503,21,18091
2020-05-03,SD,2631,15786,21,18417
2020-05-04,SD,2668,16045,21,18713
2020-05-05,SD,2721,16301,24,19022
2020-05-06,SD,2779,16637,29,19416
2020-05-07,SD,2905,17209,31,20114
2020-05-08,SD,3144,18149,31,21293
2020-05-09,SD,3393,19559,34,22952
2020-05-10,SD,3517,20377,34,23894
2020-05-11,SD,3614,20964,34,24578
2020-05-12,SD,3663,21534,39,25197
2020-05-13,SD,3732,22112,39,25844
2020-05-14,SD,3792,22681,43,26473
2020-05-15,SD,3887,23527,44,27414
2020-05-16,SD,3959,24217,44,28176
2020-05-17,SD,3987,24572,44,28559
2020-05-18,SD,4027,25018,44,29045
2020-05-19,SD,4085,25624,46,29709
2020-05-20,SD,4177,26212,46,30389
2020-05-21,SD,4250,27051,48,31301
2020-05-22,SD,4356,27988,50,32344
2020-05-23,SD,4468,29060,50,33528
2020-05-24,SD,4563,30342,50,34905
2020-05-25,SD,4586,30697,50,35283
2020-05-26,SD,4653,32385,50,37038
2020-05-27,SD,4710,33296,54,38006
2020-05-28,SD,4793,34233,54,39026
2020-05-29,SD,4866,35816,59,40682
2020-05-30,SD,4960,37978,62,42938
2020-05-31,SD,4993,39135,62,44128
2020-06-01,SD,5034,40627,62,45661
2020-06-02,SD,5067,41779,62,46846
2020-06-03,SD,5162,43500,62,48662
2020-06-04,SD,5247,47375,64,52622
2020-06-05,SD,5277,48086,65,53363
2020-06-06,SD,5367,50091,65,55458
2020-06-07,SD,5438,51622,65,57060
2020-06-08,SD,5471,52348,65,57819
2020-06-09,SD,5523,53636,68,59159
2020-06-10,SD,5604,55081,69,60685
2020-06-11,SD,5665,56079,73,61744
2020-06-12,SD,5742,57263,74,63005
2020-06-13,SD,5833,58680,75,64513
2020-06-14,SD,5898,59421,75,65319
2020-06-15,SD,5928,60467,75,66395
2020-06-16,SD,5966,61236,77,67202
2020-06-17,SD,6050,62938,78,68988
2020-06-18,SD,6109,64244,78,70353
2020-06-19,SD,6158,65035,81,71193
2020-06-20,SD,6225,65690,81,71915
2020-06-21,SD,6297,66729,81,73026
2020-06-22,SD,6326,67003,81,73329
2020-06-23,SD,6353,67633,83,73986
2020-06-24,SD,6419,68658,84,75077
2020-06-25,SD,6479,69375,87,75854
2020-06-26,SD,6535,70480,88,77015
2020-06-27,SD,6626,71474,91,78100
2020-06-28,SD,6681,72212,91,78893
2020-06-29,SD,6716,72741,91,79457
2020-06-30,SD,6764,73324,91,80088
2020-07-01,SD,6826,74117,93,80943
2020-07-02,SD,6893,75048,97,81941
2020-07-03,SD,6978,76015,97,82993
2020-07-04,SD,7028,76802,97,83830
2020-07-05,SD,7063,76940,97,84003
2020-07-06,SD,7105,77198,97,84303
2020-07-07,SD,7163,78202,98,85365
2020-07-08,SD,7242,78984,98,86226
2020-07-09,SD,7336,79974,101,87310
2020-07-10,SD,7401,81141,107,88542
2020-07-11,SD,7454,82152,109,89606
2020-07-12,SD,7499,83109,109,90608
2020-07-13,SD,7524,83854,109,91378
2020-07-14,SD,7572,84592,109,92164
2020-07-15,SD,7652,85891,111,93543
2020-07-16,SD,7694,86342,115,94036
2020-07-17,SD,7789,88184,116,95973
2020-07-18,SD,7862,89385,116,97247
2020-07-19,SD,7906,90181,118,98087
2020-07-20,SD,7943,90711,118,98654
2020-07-21,SD,8019,91826,118,99845
2020-07-22,SD,8077,92981,119,101058
2020-07-23,SD,8143,94393,121,102536
2020-03-05,TN,1,0,0,1
2020-03-06,TN,1,0,0,1
2020-03-07,TN,1,0,0,1
2020-03-08,TN,3,0,0,3
2020-03-09,TN,3,0,0,3
2020-03-10,TN,7,0,0,7
2020-03-11,TN,7,50,0,57
2020-03-12,TN,18,79,0,97
2020-03-13,TN,26,116,0,142
2020-03-14,TN,32,130,0,162
2020-03-15,TN,39,157,0,196
2020-03-16,TN,52,270,0,322
2020-03-17,TN,73,330,0,403
2020-03-18,TN,98,349,0,447
2020-03-19,TN,154,349,0,503
2020-03-20,TN,228,563,0,791
2020-03-21,TN,371,3272,0,3643
2020-03-22,TN,505,3272,0,3777
2020-03-23,TN,615,3272,2,3887
2020-03-24,TN,667,10517,2,11184
2020-03-25,TN,784,11012,3,11796
2020-03-26,TN,957,13952,3,14909
2020-03-27,TN,1203,14888,6,16091
2020-03-28,TN,1373,16965,6,18338
2020-03-29,TN,1537,19037,7,20574
2020-03-30,TN,1834,21470,13,23304
2020-03-31,TN,2239,25121,23,27360
2020-04-01,TN,2683,29769,24,32452
2020-04-02,TN,2845,31766,32,34611
2020-04-03,TN,3067,34772,37,37839
2020-04-04,TN,3321,38070,43,41391
2020-04-05,TN,3633,41667,44,45300
2020-04-06,TN,3802,43548,65,47350
2020-04-07,TN,4138,48736,72,52874
2020-04-08,TN,4362,52256,79,56618
2020-04-09,TN,4634,55215,94,59849
2020-04-10,TN,4862,57937,98,62799
2020-04-11,TN,5114,61714,101,66828
2020-04-12,TN,5308,65369,101,70677
2020-04-13,TN,5610,70585,109,76195
2020-04-14,TN,5823,73008,124,78831
2020-04-15,TN,6079,74817,135,80896
2020-04-16,TN,6262,78787,141,85049
2020-04-17,TN,6589,80684,142,87273
2020-04-18,TN,6762,83824,145,90586
2020-04-19,TN,7070,90028,148,97098
2020-04-20,TN,7238,93451,152,100689
2020-04-21,TN,7394,100788,157,108182
2020-04-22,TN,7842,107138,166,114980
2020-04-23,TN,8266,114834,170,123100
2020-04-24,TN,8726,122602,168,131328
2020-04-25,TN,9189,132217,178,141406
2020-04-26,TN,9667,137807,181,147474
2020-04-27,TN,9918,144484,184,154402
2020-04-28,TN,10052,151876,188,161928
2020-04-29,TN,10366,158183,195,168549
2020-04-30,TN,10735,166891,199,177626
2020-05-01,TN,11891,174241,204,186132
2020-05-02,TN,12661,183615,209,196276
2020-05-03,TN,13177,191430,210,204607
2020-05-04,TN,13571,197872,219,211443
2020-05-05,TN,13690,205172,226,218862
2020-05-06,TN,13938,213163,239,227101
2020-05-07,TN,14096,222232,237,236328
2020-05-08,TN,14441,229137,241,243578
2020-05-09,TN,14768,237980,242,252748
2020-05-10,TN,14985,246884,243,261869
2020-05-11,TN,15544,257733,251,273277
2020-05-12,TN,16111,267713,265,283824
2020-05-13,TN,16370,276547,273,292917
2020-05-14,TN,16699,285618,287,302317
2020-05-15,TN,16970,292786,290,309756
2020-05-16,TN,17288,302913,295,320201
2020-05-17,TN,17388,307892,298,325280
2020-05-18,TN,18011,319417,301,337428
2020-05-19,TN,18378,327745,305,346123
2020-05-20,TN,18532,335481,309,354013
2020-05-21,TN,18961,341622,313,360583
2020-05-22,TN,19394,348776,315,368170
2020-05-23,TN,19789,353969,329,373758
2020-05-24,TN,20145,363431,336,383576
2020-05-25,TN,20607,375612,338,396219
2020-05-26,TN,20965,382539,343,403504
2020-05-27,TN,21306,388324,353,409630
2020-05-28,TN,21679,394310,356,415989
2020-05-29,TN,22085,399882,360,421967
2020-05-30,TN,22566,404480,364,427046
2020-05-31,TN,23006,412971,364,435977
2020-06-01,TN,23554,424939,367,448493
2020-06-02,TN,24375,437761,381,462136
2020-06-03,TN,24822,445957,388,470779
2020-06-04,TN,25120,451018,401,476138
2020-06-05,TN,25520,456652,408,482172
2020-06-06,TN,26071,465350,417,491421
2020-06-07,TN,26381,472387,418,498768
2020-06-08,TN,26944,485819,421,512763
2020-06-09,TN,27575,493622,435,521197
2020-06-10,TN,28061,500766,436,528827
2020-06-11,TN,28538,506756,441,535294
2020-06-12,TN,29126,561047,468,590173
2020-06-13,TN,29541,571821,472,601362
2020-06-14,TN,30432,584788,475,615220
2020-06-15,TN,31160,598818,483,629978
2020-06-16,TN,31830,607160,493,638990
2020-06-17,TN,32143,612430,497,644573
2020-06-18,TN,32829,619565,509,652394
2020-06-19,TN,34017,627672,515,661689
2020-06-20,TN,34446,640894,524,675340
2020-06-21,TN,35102,650527,526,685629
2020-06-22,TN,35553,664552,531,700105
2020-06-23,TN,36303,669116,542,705419
2020-06-24,TN,37235,681069,556,718304
2020-06-25,TN,38034,689515,567,727549
2020-06-26,TN,39444,702588,577,742032
2020-06-27,TN,40172,708381,584,748553
2020-06-28,TN,40172,708381,584,748553
2020-06-29,TN,42297,734909,592,777206
2020-06-30,TN,43509,749618,604,793127
2020-07-01,TN,45315,772571,609,817886
2020-07-02,TN,46890,791564,620,838454
2020-07-03,TN,48712,813777,633,862489
2020-07-04,TN,50140,828464,637,878604
2020-07-05,TN,51431,844735,646,896166
2020-07-06,TN,52155,852463,653,904618
2020-07-07,TN,53514,867685,665,921199
2020-07-08,TN,55986,894973,685,950959
2020-07-09,TN,57591,915123,710,972714
2020-07-10,TN,59546,935029,723,994575
2020-07-11,TN,61006,946108,738,1007114
2020-07-12,TN,61960,956055,741,1018015
2020-07-13,TN,65274,988687,749,1053961
2020-07-14,TN,66788,1005100,767,1071888
2020-07-15,TN,69061,1028612,783,1097673
2020-07-16,TN,71540,1052157,796,1123697
2020-07-17,TN,73819,1076853,815,1150672
2020-07-18,TN,76336,1097316,838,1173652
2020-07-19,TN,78115,1119182,843,1197297
2020-07-20,TN,79754,1135413,847,1215167
2020-07-21,TN,81944,1156289,871,1238233
2020-07-22,TN,84417,1179411,888,1263828
2020-07-23,TN,86987,1208998,925,1295985
2020-03-04,TX,1,0,0,1
2020-03-05,TX,1,0,0,1
2020-03-06,TX,5,0,0,5
2020-03-07,TX,8,0,0,8
2020-03-08,TX,8,0,0,8
2020-03-09,TX,12,0,0,12
2020-03-10,TX,13,0,0,13
2020-03-11,TX,21,0,0,21
2020-03-12,TX,23,0,0,23
2020-03-13,TX,39,0,0,39
2020-03-14,TX,51,0,0,51
2020-03-15,TX,56,0,0,56
2020-03-16,TX,57,0,0,57
2020-03-17,TX,64,1204,1,1268
2020-03-18,TX,83,1824,2,1907
2020-03-19,TX,143,2212,3,2355
2020-03-20,TX,194,5083,5,5277
2020-03-21,TX,304,6218,5,6522
2020-03-22,TX,334,8422,5,8756
2020-03-23,TX,352,9703,8,10055
2020-03-24,TX,410,10757,9,11167
2020-03-25,TX,974,12520,12,13494
2020-03-26,TX,1396,20028,18,21424
2020-03-27,TX,1731,21935,23,23666
2020-03-28,TX,2052,23208,27,25260
2020-03-29,TX,2552,23208,34,25760
2020-03-30,TX,2877,33003,34,35880
2020-03-31,TX,3266,39726,41,42992
2020-04-01,TX,3997,43860,58,47857
2020-04-02,TX,4669,46010,70,50679
2020-04-03,TX,5330,50434,90,55764
2020-04-04,TX,6110,57641,105,63751
2020-04-05,TX,6812,64126,127,70938
2020-04-06,TX,7276,78081,140,85357
2020-04-07,TX,8262,80387,154,88649
2020-04-08,TX,9353,86905,177,96258
2020-04-09,TX,10230,95904,199,106134
2020-04-10,TX,11671,104047,226,115718
2020-04-11,TX,12561,107972,254,120533
2020-04-12,TX,13484,111049,271,124533
2020-04-13,TX,13906,119320,287,133226
2020-04-14,TX,14624,131843,318,146467
2020-04-15,TX,15492,136318,364,151810
2020-04-16,TX,16455,142092,393,158547
2020-04-17,TX,17371,152165,428,169536
2020-04-18,TX,18260,157979,453,176239
2020-04-19,TX,18923,163787,477,182710
2020-04-20,TX,19458,170936,495,190394
2020-04-21,TX,20196,185203,517,205399
2020-04-22,TX,21069,195714,543,216783
2020-04-23,TX,21944,203134,561,225078
2020-04-24,TX,22806,219741,593,242547
2020-04-25,TX,23773,239043,623,262816
2020-04-26,TX,24631,251390,648,276021
2020-04-27,TX,25297,265220,663,290517
2020-04-28,TX,26171,274213,690,300384
2020-04-29,TX,27054,287736,732,314790
2020-04-30,TX,28087,302213,782,330300
2020-05-01,TX,29229,322546,816,351775
2020-05-02,TX,30522,350126,847,380648
2020-05-03,TX,31548,359012,867,390560
2020-05-04,TX,32332,375066,884,407398
2020-05-05,TX,33369,393841,906,427210
2020-05-06,TX,34422,404516,948,438938
2020-05-07,TX,35390,419772,973,455162
2020-05-08,TX,36609,440509,1004,477118
2020-05-09,TX,37860,451434,1049,489294
2020-05-10,TX,38869,462907,1088,501776
2020-05-11,TX,39869,485828,1100,525697
2020-05-12,TX,41048,497124,1133,538172
2020-05-13,TX,42403,514373,1158,556776
2020-05-14,TX,43851,543462,1216,587313
2020-05-15,TX,45198,564432,1272,609630
2020-05-16,TX,46999,591740,1305,638739
2020-05-17,TX,47784,602571,1336,650355
2020-05-18,TX,48693,631152,1347,679845
2020-05-19,TX,49912,650234,1369,700146
2020-05-20,TX,51323,669605,1419,720928
2020-05-21,TX,52268,687913,1440,740181
2020-05-22,TX,53449,687913,1480,741362
2020-05-23,TX,54509,708197,1506,762706
2020-05-24,TX,55348,708197,1506,763545
2020-05-25,TX,55971,749683,1527,805654
2020-05-26,TX,56560,764673,1536,821233
2020-05-27,TX,57921,797753,1562,855674
2020-05-28,TX,59776,813442,1601,873218
2020-05-29,TX,61006,832269,1626,893275
2020-05-30,TX,62338,866179,1626,928517
2020-05-31,TX,64287,887578,1672,951865
2020-06-01,TX,64880,905151,1678,970031
2020-06-02,TX,66568,919656,1698,986224
2020-06-03,TX,68271,938497,1734,1006768
2020-06-04,TX,69920,968635,1767,1038555
2020-06-05,TX,71613,989963,1788,1061576
2020-06-06,TX,73553,1019724,1819,1093277
2020-06-07,TX,74978,1025468,1830,1100446
2020-06-08,TX,75616,1044700,1830,1120316
2020-06-09,TX,77253,1070102,1853,1147355
2020-06-10,TX,79757,1081330,1885,1161087
2020-06-11,TX,81583,1124737,1920,1206320
2020-06-12,TX,83680,1143277,1939,1226957
2020-06-13,TX,86011,1174308,1957,1260319
2020-06-14,TX,87854,1208129,1976,1295983
2020-06-15,TX,89108,1225653,1983,1314761
2020-06-16,TX,93206,1255236,2029,1348442
2020-06-17,TX,96335,1273303,2062,1369638
2020-06-18,TX,99851,1307890,2105,1407741
2020-06-19,TX,103305,1320609,2140,1423914
2020-06-20,TX,107735,1355663,2165,1463398
2020-06-21,TX,111601,1414579,2182,1526180
2020-06-22,TX,114881,1434128,2192,1549009
2020-06-23,TX,120370,1476920,2220,1597290
2020-06-24,TX,125921,1504337,2249,1630258
2020-06-25,TX,131917,1527423,2296,1659340
2020-06-26,TX,137624,1559710,2324,1697334
2020-06-27,TX,143371,1579455,2366,1722826
2020-06-28,TX,148728,1626491,2393,1775219
2020-06-29,TX,153011,1666178,2403,1819189
2020-06-30,TX,159986,1709296,2424,1869282
2020-07-01,TX,168062,1753886,2481,1921948
2020-07-02,TX,175977,1799826,2525,1975803
2020-07-03,TX,183532,1830374,2575,2013906
2020-07-04,TX,191790,1880019,2608,2071809
2020-07-05,TX,195239,1938218,2637,2133457
2020-07-06,TX,200557,1963172,2655,2163729
2020-07-07,TX,210585,2010702,2715,2221287
2020-07-08,TX,220564,2038144,2813,2258708
2020-07-09,TX,230346,2082866,2918,2313212
2020-07-10,TX,240111,2149678,3013,2389789
2020-07-11,TX,250462,2179162,3112,2429624
2020-07-12,TX,258658,2234096,3192,2492754
2020-07-13,TX,264313,2275812,3235,2540125
2020-07-14,TX,275058,2323622,3322,2598680
2020-07-15,TX,282365,2359834,3432,2642199
2020-07-16,TX,292656,2407199,3561,2699855
2020-07-17,TX,307572,2459749,3735,2767321
2020-07-18,TX,317730,2524955,3865,2842685
2020-07-19,TX,325030,2607334,3958,2932364
2020-07-20,TX,332434,2652120,4020,2984554
2020-07-21,TX,341739,2701835,4151,3043574
2020-07-22,TX,351618,2752530,4348,3104148
2020-07-23,TX,361125,2803531,4521,3164656
2020-03-07,UT,1,0,0,1
2020-03-08,UT,1,0,0,1
2020-03-09,UT,1,0,0,1
2020-03-10,UT,2,0,0,2
2020-03-11,UT,2,0,0,2
2020-03-12,UT,4,131,0,135
2020-03-13,UT,6,131,0,137
2020-03-14,UT,6,131,0,137
2020-03-15,UT,28,131,0,159
2020-03-16,UT,39,131,0,170
2020-03-17,UT,51,131,0,182
2020-03-18,UT,63,131,0,194
2020-03-19,UT,78,1448,0,1526
2020-03-20,UT,112,2035,0,2147
2020-03-21,UT,136,2424,0,2560
2020-03-22,UT,181,3508,1,3689
2020-03-23,UT,257,4790,1,5047
2020-03-24,UT,299,5524,1,5823
2020-03-25,UT,346,6491,1,6837
2020-03-26,UT,402,7308,1,7710
2020-03-27,UT,480,8764,2,9244
2020-03-28,UT,602,10710,2,11312
2020-03-29,UT,719,13274,2,13993
2020-03-30,UT,806,15197,4,16003
2020-03-31,UT,887,17626,5,18513
2020-04-01,UT,1012,20155,7,21167
2020-04-02,UT,1074,20155,7,21229
2020-04-03,UT,1246,23002,7,24248
2020-04-04,UT,1428,26615,8,28043
2020-04-05,UT,1605,29287,8,30892
2020-04-06,UT,1675,31719,13,33394
2020-04-07,UT,1738,32909,13,34647
2020-04-08,UT,1846,34270,13,36116
2020-04-09,UT,1976,36397,13,38373
2020-04-10,UT,2102,38660,17,40762
2020-04-11,UT,2206,40340,18,42546
2020-04-12,UT,2303,41931,18,44234
2020-04-13,UT,2363,43424,18,45787
2020-04-14,UT,2412,44064,19,46476
2020-04-15,UT,2542,45072,20,47614
2020-04-16,UT,2683,46995,21,49678
2020-04-17,UT,2805,52966,23,55771
2020-04-18,UT,2931,57013,25,59944
2020-04-19,UT,3069,60486,27,63555
2020-04-20,UT,3213,65098,28,68311
2020-04-21,UT,3296,69062,32,72358
2020-04-22,UT,3445,73015,34,76460
2020-04-23,UT,3612,77015,35,80627
2020-04-24,UT,3782,80915,39,84697
2020-04-25,UT,3948,86258,41,90206
2020-04-26,UT,4123,91579,41,95702
2020-04-27,UT,4233,95962,41,100195
2020-04-28,UT,4343,98096,45,102439
2020-04-29,UT,4495,101283,45,105778
2020-04-30,UT,4672,103829,46,108501
2020-05-01,UT,4828,107730,46,112558
2020-05-02,UT,4981,112823,49,117804
2020-05-03,UT,5175,116927,50,122102
2020-05-04,UT,5317,119344,50,124661
2020-05-05,UT,5449,121266,56,126715
2020-05-06,UT,5595,125407,58,131002
2020-05-07,UT,5724,128819,61,134543
2020-05-08,UT,5919,132769,61,138688
2020-05-09,UT,6103,137191,66,143294
2020-05-10,UT,6251,140259,67,146510
2020-05-11,UT,6362,144223,68,150585
2020-05-12,UT,6432,147053,73,153485
2020-05-13,UT,6620,150166,75,156786
2020-05-14,UT,6749,153370,75,160119
2020-05-15,UT,6913,156305,77,163218
2020-05-16,UT,7068,159706,78,166774
2020-05-17,UT,7238,163514,80,170752
2020-05-18,UT,7384,166638,80,174022
2020-05-19,UT,7518,169793,88,177311
2020-05-20,UT,7710,171954,90,179664
2020-05-21,UT,7874,175000,92,182874
2020-05-22,UT,8057,178777,93,186834
2020-05-23,UT,8260,182519,97,190779
2020-05-24,UT,8392,186041,97,194433
2020-05-25,UT,8521,187947,98,196468
2020-05-26,UT,8620,189972,101,198592
2020-05-27,UT,8706,191920,105,200626
2020-05-28,UT,8921,194586,106,203507
2020-05-29,UT,9264,196591,107,205855
2020-05-30,UT,9533,200572,112,210105
2020-05-31,UT,9797,204117,113,213914
2020-06-01,UT,9999,208113,113,218112
2020-06-02,UT,10202,211589,113,221791
2020-06-03,UT,10497,213484,117,223981
2020-06-04,UT,10813,216694,117,227507
2020-06-05,UT,11252,220945,120,232197
2020-06-06,UT,11798,223351,121,235149
2020-06-07,UT,12066,225885,121,237951
2020-06-08,UT,12322,230577,124,242899
2020-06-09,UT,12559,234301,127,246860
2020-06-10,UT,12864,236896,128,249760
2020-06-11,UT,13252,241416,131,254668
2020-06-12,UT,13577,245209,139,258786
2020-06-13,UT,13981,248801,139,262782
2020-06-14,UT,14313,253400,139,267713
2020-06-15,UT,14608,258330,143,272938
2020-06-16,UT,14937,260763,145,275700
2020-06-17,UT,15344,263348,149,278692
2020-06-18,UT,15839,266846,152,282685
2020-06-19,UT,16425,270933,155,287358
2020-06-20,UT,17068,275809,155,292877
2020-06-21,UT,17462,278933,158,296395
2020-06-22,UT,17906,281406,158,299312
2020-06-23,UT,18300,283976,163,302276
2020-06-24,UT,18784,285954,163,304738
2020-06-25,UT,19374,292680,164,312054
2020-06-26,UT,20050,297518,166,317568
2020-06-27,UT,20628,302174,167,322802
2020-06-28,UT,21100,307349,167,328449
2020-06-29,UT,21664,312241,168,333905
2020-06-30,UT,22217,318536,172,340753
2020-07-01,UT,22716,320642,173,343358
2020-07-02,UT,23270,323116,176,346386
2020-07-03,UT,23866,332770,181,356636
2020-07-04,UT,24542,342174,181,366716
2020-07-05,UT,24952,346356,184,371308
2020-07-06,UT,25469,350373,190,375842
2020-07-07,UT,26033,356816,194,382849
2020-07-08,UT,26755,359005,201,385760
2020-07-09,UT,27356,361377,205,388733
2020-07-10,UT,28223,367751,207,395974
2020-07-11,UT,28855,376497,212,405352
2020-07-12,UT,29484,383574,215,413058
2020-07-13,UT,30030,388305,216,418335
2020-07-14,UT,30478,394043,226,424521
2020-07-15,UT,30891,401189,233,432080
2020-07-16,UT,31845,407683,234,439528
2020-07-17,UT,32572,415234,235,447806
2020-07-18,UT,33332,422908,243,456240
2020-07-19,UT,34117,428705,243,462822
2020-07-20,UT,34526,434878,247,469404
2020-07-21,UT,35012,440431,251,475443
2020-07-22,UT,35578,445824,260,481402
2020-07-23,UT,36099,449323,267,485422
2020-03-05,VA,0,18,0,18
2020-03-06,VA,0,21,0,21
2020-03-07,VA,0,31,0,31
2020-03-08,VA,2,36,0,38
2020-03-09,VA,3,38,0,41
2020-03-10,VA,8,53,0,61
2020-03-11,VA,9,60,0,69
2020-03-12,VA,17,117,0,134
2020-03-13,VA,30,117,0,147
2020-03-14,VA,30,117,0,147
2020-03-15,VA,45,363,1,408
2020-03-16,VA,51,438,1,489
2020-03-17,VA,67,961,1,1028
2020-03-18,VA,77,1201,1,1278
2020-03-19,VA,94,1829,2,1923
2020-03-20,VA,114,2211,2,2325
2020-03-21,VA,152,2638,2,2790
2020-03-22,VA,219,3118,3,3337
2020-03-23,VA,254,3443,6,3697
2020-03-24,VA,290,4180,7,4470
2020-03-25,VA,391,4979,9,5370
2020-03-26,VA,460,5729,13,6189
2020-03-27,VA,604,6733,14,7337
2020-03-28,VA,739,8427,17,9166
2020-03-29,VA,890,9719,22,10609
2020-03-30,VA,1020,11018,25,12038
2020-03-31,VA,1250,12151,27,13401
2020-04-01,VA,1484,13860,34,15344
2020-04-02,VA,1706,15883,41,17589
2020-04-03,VA,2012,16993,46,19005
2020-04-04,VA,2407,19145,52,21552
2020-04-05,VA,2637,21034,51,23671
2020-04-06,VA,2878,21643,54,24521
2020-04-07,VA,3333,25312,63,28645
2020-04-08,VA,3645,27000,75,30645
2020-04-09,VA,4042,28984,109,33026
2020-04-10,VA,4509,30950,121,35459
2020-04-11,VA,5077,32922,130,37999
2020-04-12,VA,5274,34711,141,39985
2020-04-13,VA,5747,35654,149,41401
2020-04-14,VA,6171,36592,154,42763
2020-04-15,VA,6500,37669,195,44169
2020-04-16,VA,6889,39555,208,46444
2020-04-17,VA,7491,41506,231,48997
2020-04-18,VA,8053,43878,258,51931
2020-04-19,VA,8537,46196,277,54733
2020-04-20,VA,8990,47745,300,56735
2020-04-21,VA,9630,48724,324,58354
2020-04-22,VA,10266,50512,349,60778
2020-04-23,VA,10998,53891,372,64889
2020-04-24,VA,11594,57846,410,69440
2020-04-25,VA,12366,60276,436,72642
2020-04-26,VA,12970,63630,448,76600
2020-04-27,VA,13535,67144,458,80679
2020-04-28,VA,14339,68959,492,83298
2020-04-29,VA,14961,70979,522,85940
2020-04-30,VA,15846,75663,552,91509
2020-05-01,VA,16901,89539,581,106440
2020-05-02,VA,17731,84365,616,102096
2020-05-03,VA,18671,89331,660,108002
2020-05-04,VA,19492,92801,684,112293
2020-05-05,VA,20256,93452,713,113708
2020-05-06,VA,20256,93452,713,113708
2020-05-07,VA,21570,101582,769,123152
2020-05-08,VA,22342,107603,812,129945
2020-05-09,VA,23196,113953,827,137149
2020-05-10,VA,24081,118974,839,143055
2020-05-11,VA,25070,125547,850,150617
2020-05-12,VA,25800,129529,891,155329
2020-05-13,VA,26746,134646,927,161392
2020-05-14,VA,27813,139017,955,166830
2020-05-15,VA,28672,149342,977,178014
2020-05-16,VA,29683,155885,1002,185568
2020-05-17,VA,30388,159973,1009,190361
2020-05-18,VA,31140,165086,1014,196226
2020-05-19,VA,32145,170644,1041,202789
2020-05-20,VA,32908,179718,1074,212626
2020-05-21,VA,34137,184462,1099,218599
2020-05-22,VA,34950,190225,1136,225175
2020-05-23,VA,35749,196721,1159,232470
2020-05-24,VA,36244,207841,1171,244085
2020-05-25,VA,37727,221023,1208,258750
2020-05-26,VA,39342,227839,1236,267181
2020-05-27,VA,40249,236798,1281,277047
2020-05-28,VA,41401,245880,1338,287281
2020-05-29,VA,42533,255844,1358,298377
2020-05-30,VA,43611,261901,1370,305512
2020-05-31,VA,44607,270784,1375,315391
2020-06-01,VA,45398,279321,1392,324719
2020-06-02,VA,46239,282650,1407,328889
2020-06-03,VA,46905,295482,1428,342387
2020-06-04,VA,47856,305734,1445,353590
2020-06-05,VA,48532,315238,1453,363770
2020-06-06,VA,49397,321734,1460,371131
2020-06-07,VA,50681,329135,1472,379816
2020-06-08,VA,51251,332341,1477,383592
2020-06-09,VA,51738,339118,1496,390856
2020-06-10,VA,52177,346187,1514,398364
2020-06-11,VA,52647,354750,1520,407397
2020-06-12,VA,53211,397319,1534,450530
2020-06-13,VA,53869,406124,1541,459993
2020-06-14,VA,54506,414494,1546,469000
2020-06-15,VA,54886,424113,1552,478999
2020-06-16,VA,55331,430107,1570,485438
2020-06-17,VA,55775,438566,1583,494341
2020-06-18,VA,56238,445830,1586,502068
2020-06-19,VA,56793,455618,1602,512411
2020-06-20,VA,57443,473961,1607,531404
2020-06-21,VA,57994,487682,1611,545676
2020-06-22,VA,58465,499658,1620,558123
2020-06-23,VA,58994,509383,1645,568377
2020-06-24,VA,59514,517057,1661,576571
2020-06-25,VA,59946,533020,1675,592966
2020-06-26,VA,60570,545893,1700,606463
2020-06-27,VA,61247,556679,1724,617926
2020-06-28,VA,61736,566592,1732,628328
2020-06-29,VA,62189,574183,1740,636372
2020-06-30,VA,62787,582247,1763,645034
2020-07-01,VA,63203,595430,1786,658633
2020-07-02,VA,63735,610521,1816,674256
2020-07-03,VA,64393,623967,1845,688360
2020-07-04,VA,65109,634120,1849,699229
2020-07-05,VA,65748,643607,1853,709355
2020-07-06,VA,66102,649011,1853,715113
2020-07-07,VA,66740,661377,1881,728117
2020-07-08,VA,67375,670624,1905,737999
2020-07-09,VA,67988,685440,1937,753428
2020-07-10,VA,68931,699794,1958,768725
2020-07-11,VA,69782,716553,1962,786335
2020-07-12,VA,70670,733375,1966,804045
2020-07-13,VA,71642,742373,1968,814015
2020-07-14,VA,72443,758407,1977,830850
2020-07-15,VA,73527,771455,1992,844982
2020-07-16,VA,74431,786742,2007,861173
2020-07-17,VA,75433,801271,2013,876704
2020-07-18,VA,76373,813328,2025,889701
2020-07-19,VA,77430,829933,2027,907363
2020-07-20,VA,78375,842086,2031,920461
2020-07-21,VA,79371,860721,2048,940092
2020-07-22,VA,80393,873794,2051,954187
2020-07-23,VA,81237,890963,2054,972200
2020-03-16,VI,1,0,0,1
2020-03-17,VI,2,0,0,2
2020-03-18,VI,2,0,0,2
2020-03-19,VI,3,0,0,3
2020-03-20,VI,3,0,0,3
2020-03-21,VI,6,0,0,6
2020-03-22,VI,6,0,0,6
2020-03-23,VI,17,0,0,17
2020-03-24,VI,17,0,0,17
2020-03-25,VI,17,55,0,72
2020-03-26,VI,17,55,0,72
2020-03-27,VI,19,55,0,74
2020-03-28,VI,22,106,0,128
2020-03-29,VI,23,123,0,146
2020-03-30,VI,30,126,0,156
2020-03-31,VI,30,126,0,156
2020-04-01,VI,30,126,0,156
2020-04-02,VI,33,149,0,182
2020-04-03,VI,38,154,0,192
2020-04-04,VI,40,184,0,224
2020-04-05,VI,42,206,1,248
2020-04-06,VI,43,222,1,265
2020-04-07,VI,43,222,1,265
2020-04-08,VI,45,242,1,287
2020-04-09,VI,46,251,1,297
2020-04-10,VI,50,273,1,323
2020-04-11,VI,51,299,1,350
2020-04-12,VI,51,299,1,350
2020-04-13,VI,51,322,1,373
2020-04-14,VI,51,326,1,377
2020-04-15,VI,51,331,1,382
2020-04-16,VI,51,357,1,408
2020-04-17,VI,51,373,2,424
2020-04-18,VI,53,390,3,443
2020-04-19,VI,53,548,3,601
2020-04-20,VI,53,554,3,607
2020-04-21,VI,54,574,3,628
2020-04-22,VI,54,583,3,637
2020-04-23,VI,54,583,3,637
2020-04-24,VI,54,642,3,696
2020-04-25,VI,55,693,3,748
2020-04-26,VI,57,700,4,757
2020-04-27,VI,59,716,4,775
2020-04-28,VI,59,719,4,778
2020-04-29,VI,62,732,4,794
2020-04-30,VI,66,807,4,873
2020-05-01,VI,66,811,4,877
2020-05-02,VI,66,922,4,988
2020-05-03,VI,66,951,4,1017
2020-05-04,VI,66,965,4,1031
2020-05-05,VI,66,973,4,1039
2020-05-06,VI,66,990,4,1056
2020-05-07,VI,66,990,4,1056
2020-05-08,VI,68,1024,4,1092
2020-05-09,VI,68,1024,4,1092
2020-05-10,VI,69,1102,4,1171
2020-05-11,VI,69,1110,5,1179
2020-05-12,VI,69,1115,6,1184
2020-05-13,VI,69,1128,6,1197
2020-05-14,VI,69,1164,6,1233
2020-05-15,VI,69,1194,6,1263
2020-05-16,VI,69,1194,6,1263
2020-05-17,VI,69,1278,6,1347
2020-05-18,VI,69,1278,6,1347
2020-05-19,VI,69,1298,6,1367
2020-05-20,VI,69,1314,6,1383
2020-05-21,VI,69,1314,6,1383
2020-05-22,VI,69,1343,6,1412
2020-05-23,VI,69,1343,6,1412
2020-05-24,VI,69,1343,6,1412
2020-05-25,VI,69,1343,6,1412
2020-05-26,VI,69,1425,6,1494
2020-05-27,VI,69,1442,6,1511
2020-05-28,VI,69,1617,6,1686
2020-05-29,VI,69,1633,6,1702
2020-05-30,VI,69,1633,6,1702
2020-05-31,VI,69,1633,6,1702
2020-06-01,VI,70,1741,6,1811
2020-06-02,VI,70,1936,6,2006
2020-06-03,VI,70,1956,6,2026
2020-06-04,VI,71,1975,6,2046
2020-06-05,VI,71,1980,6,2051
2020-06-06,VI,71,2125,6,2196
2020-06-07,VI,71,2125,6,2196
2020-06-08,VI,71,2128,6,2199
2020-06-09,VI,71,2137,6,2208
2020-06-10,VI,72,2169,6,2241
2020-06-11,VI,72,2180,6,2252
2020-06-12,VI,72,2221,6,2293
2020-06-13,VI,72,2284,6,2356
2020-06-14,VI,72,2305,6,2377
2020-06-15,VI,73,2305,6,2378
2020-06-16,VI,73,2305,6,2378
2020-06-17,VI,73,2354,6,2427
2020-06-18,VI,73,2354,6,2427
2020-06-19,VI,74,2450,6,2524
2020-06-20,VI,74,2492,6,2566
2020-06-21,VI,76,2502,6,2578
2020-06-22,VI,76,2502,6,2578
2020-06-23,VI,76,2544,6,2620
2020-06-24,VI,78,2593,6,2671
2020-06-25,VI,80,2654,6,2734
2020-06-26,VI,81,2705,6,2786
2020-06-27,VI,81,2746,6,2827
2020-06-28,VI,81,2746,6,2827
2020-06-29,VI,81,2746,6,2827
2020-06-30,VI,84,2819,6,2903
2020-07-01,VI,90,2876,6,2966
2020-07-02,VI,92,2924,6,3016
2020-07-03,VI,98,2963,6,3061
2020-07-04,VI,111,3060,6,3171
2020-07-05,VI,111,3060,6,3171
2020-07-06,VI,112,3118,6,3230
2020-07-07,VI,116,3183,6,3299
2020-07-08,VI,122,3273,6,3395
2020-07-09,VI,144,3370,6,3514
2020-07-10,VI,153,3473,6,3626
2020-07-11,VI,167,3640,6,3807
2020-07-12,VI,181,3908,6,4089
2020-07-13,VI,206,4084,6,4290
2020-07-14,VI,206,4084,6,4290
2020-07-15,VI,243,4637,6,4880
2020-07-16,VI,249,5036,6,5285
2020-07-17,VI,263,5790,6,6053
2020-07-18,VI,283,6239,6,6522
2020-07-19,VI,297,6587,6,6884
2020-07-20,VI,304,6617,6,6921
2020-07-21,VI,308,6853,6,7161
2020-07-22,VI,320,7146,7,7466
2020-07-23,VI,336,7500,7,7836
2020-03-06,VT,0,0,0,0
2020-03-07,VT,1,25,0,26
2020-03-08,VT,1,30,0,31
2020-03-09,VT,1,36,0,37
2020-03-10,VT,1,60,0,61
2020-03-11,VT,2,91,0,93
2020-03-12,VT,2,136,0,138
2020-03-13,VT,5,223,0,228
2020-03-14,VT,8,332,0,340
2020-03-15,VT,12,405,0,417
2020-03-16,VT,17,487,0,504
2020-03-17,VT,19,581,0,600
2020-03-18,VT,21,637,0,658
2020-03-19,VT,28,764,0,792
2020-03-20,VT,44,957,2,1001
2020-03-21,VT,52,1080,2,1132
2020-03-22,VT,76,1204,2,1280
2020-03-23,VT,97,1424,5,1521
2020-03-24,VT,125,1569,7,1694
2020-03-25,VT,160,1810,8,1970
2020-03-26,VT,185,2744,9,2929
2020-03-27,VT,213,2868,10,3081
2020-03-28,VT,234,3192,12,3426
2020-03-29,VT,256,3483,12,3739
2020-03-30,VT,293,3718,12,4011
2020-03-31,VT,320,3949,13,4269
2020-04-01,VT,359,4162,16,4521
2020-04-02,VT,390,4384,17,4774
2020-04-03,VT,460,4865,17,5325
2020-04-04,VT,512,5242,20,5754
2020-04-05,VT,543,5830,22,6373
2020-04-06,VT,575,6161,23,6736
2020-04-07,VT,608,6645,23,7253
2020-04-08,VT,631,7001,23,7632
2020-04-09,VT,680,7218,23,7898
2020-04-10,VT,713,7502,24,8215
2020-04-11,VT,733,8063,25,8796
2020-04-12,VT,754,8724,27,9478
2020-04-13,VT,761,9275,28,10036
2020-04-14,VT,770,9491,29,10261
2020-04-15,VT,779,9913,30,10692
2020-04-16,VT,792,10259,35,11051
2020-04-17,VT,802,10813,35,11615
2020-04-18,VT,813,11212,38,12025
2020-04-19,VT,817,11450,38,12267
2020-04-20,VT,820,11671,38,12491
2020-04-21,VT,828,11767,40,12595
2020-04-22,VT,831,12097,40,12928
2020-04-23,VT,834,12420,43,13254
2020-04-24,VT,843,12808,44,13651
2020-04-25,VT,852,13270,46,14122
2020-04-26,VT,855,13518,46,14373
2020-04-27,VT,862,13819,47,14681
2020-04-28,VT,862,13947,47,14809
2020-04-29,VT,866,14155,47,15021
2020-04-30,VT,879,14357,49,15236
2020-05-01,VT,885,14930,50,15815
2020-05-02,VT,896,15232,51,16128
2020-05-03,VT,901,15570,52,16471
2020-05-04,VT,906,15889,52,16795
2020-05-05,VT,909,16065,52,16974
2020-05-06,VT,914,16281,52,17195
2020-05-07,VT,916,16690,53,17606
2020-05-08,VT,918,17222,53,18140
2020-05-09,VT,926,17690,53,18616
2020-05-10,VT,926,18167,53,19093
2020-05-11,VT,927,18797,53,19724
2020-05-12,VT,929,19107,53,20036
2020-05-13,VT,930,19708,53,20638
2020-05-14,VT,931,20497,53,21428
2020-05-15,VT,932,21237,53,22169
2020-05-16,VT,940,22197,53,23137
2020-05-17,VT,940,22974,54,23914
2020-05-18,VT,944,23547,54,24491
2020-05-19,VT,944,24114,54,25058
2020-05-20,VT,944,24114,54,25058
2020-05-21,VT,950,24751,54,25701
2020-05-22,VT,952,24781,54,25733
2020-05-23,VT,954,26470,54,27424
2020-05-24,VT,956,27634,54,28590
2020-05-25,VT,962,28707,54,29669
2020-05-26,VT,967,29456,54,30423
2020-05-27,VT,971,30028,54,30999
2020-05-28,VT,974,30178,55,31152
2020-05-29,VT,975,30910,55,31885
2020-05-30,VT,977,31690,55,32667
2020-05-31,VT,981,32989,55,33970
2020-06-01,VT,983,34343,55,35326
2020-06-02,VT,988,35631,55,36619
2020-06-03,VT,990,36205,55,37195
2020-06-04,VT,1026,36808,55,37834
2020-06-05,VT,1027,38090,55,39117
2020-06-06,VT,1046,39037,55,40083
2020-06-07,VT,1063,40155,55,41218
2020-06-08,VT,1075,41723,55,42798
2020-06-09,VT,1084,43144,55,44228
2020-06-10,VT,1095,44647,55,45742
2020-06-11,VT,1110,46099,55,47209
2020-06-12,VT,1119,47515,55,48634
2020-06-13,VT,1125,48808,55,49933
2020-06-14,VT,1127,49855,55,50982
2020-06-15,VT,1128,51429,55,52557
2020-06-16,VT,1131,51759,55,52890
2020-06-17,VT,1130,52533,55,53663
2020-06-18,VT,1135,53610,56,54745
2020-06-19,VT,1144,54743,56,55887
2020-06-20,VT,1147,55881,56,57028
2020-06-21,VT,1159,56686,56,57845
2020-06-22,VT,1163,57444,56,58607
2020-06-23,VT,1164,58164,56,59328
2020-06-24,VT,1184,58676,56,59860
2020-06-25,VT,1191,59518,56,60709
2020-06-26,VT,1198,60391,56,61589
2020-06-27,VT,1200,61523,56,62723
2020-06-28,VT,1202,62663,56,63865
2020-06-29,VT,1208,63785,56,64993
2020-06-30,VT,1208,64556,56,65764
2020-07-01,VT,1210,65082,56,66292
2020-07-02,VT,1227,66114,56,67341
2020-07-03,VT,1236,67159,56,68395
2020-07-04,VT,1238,68159,56,69397
2020-07-05,VT,1249,68775,56,70024
2020-07-06,VT,1251,69102,56,70353
2020-07-07,VT,1254,69859,56,71113
2020-07-08,VT,1256,70500,56,71756
2020-07-09,VT,1272,71477,56,72749
2020-07-10,VT,1277,72821,56,74098
2020-07-11,VT,1283,73749,56,75032
2020-07-12,VT,1296,74555,56,75851
2020-07-13,VT,1301,75280,56,76581
2020-07-14,VT,1305,76319,56,77624
2020-07-15,VT,1318,77040,56,78358
2020-07-16,VT,1325,77715,56,79040
2020-07-17,VT,1334,78032,56,79366
2020-07-18,VT,1338,79108,56,80446
2020-07-19,VT,1350,81150,56,82500
2020-07-20,VT,1360,82508,56,83868
2020-07-21,VT,1366,83581,56,84947
2020-07-22,VT,1366,84376,56,85742
2020-07-23,VT,1377,85205,56,86582
2020-01-22,WA,2,0,0,2
2020-01-23,WA,2,0,0,2
2020-01-24,WA,2,0,0,2
2020-01-25,WA,2,0,0,2
2020-01-26,WA,2,0,0,2
2020-01-27,WA,2,0,0,2
2020-01-28,WA,2,0,0,2
2020-01-29,WA,3,0,0,3
2020-01-30,WA,3,0,0,3
2020-01-31,WA,3,0,0,3
2020-02-01,WA,4,0,0,4
2020-02-02,WA,6,0,0,6
2020-02-03,WA,7,0,0,7
2020-02-04,WA,8,0,0,8
2020-02-05,WA,8,0,0,8
2020-02-06,WA,11,0,0,11
2020-02-07,WA,12,0,0,12
2020-02-08,WA,13,0,0,13
2020-02-09,WA,13,0,0,13
2020-02-10,WA,16,0,0,16
2020-02-11,WA,17,0,0,17
2020-02-12,WA,18,0,0,18
2020-02-13,WA,18,0,0,18
2020-02-14,WA,21,0,0,21
2020-02-15,WA,28,0,0,28
2020-02-16,WA,35,0,0,35
2020-02-17,WA,50,0,0,50
2020-02-18,WA,59,0,0,59
2020-02-19,WA,69,0,0,69
2020-02-20,WA,82,0,0,82
2020-02-21,WA,93,0,0,93
2020-02-22,WA,106,0,0,106
2020-02-23,WA,122,0,0,122
2020-02-24,WA,148,0,0,148
2020-02-25,WA,179,0,0,179
2020-02-26,WA,208,0,2,208
2020-02-27,WA,235,0,2,235
2020-02-28,WA,275,0,4,275
2020-02-29,WA,299,17,5,316
2020-03-01,WA,377,12,8,389
2020-03-02,WA,450,123,11,573
2020-03-03,WA,534,264,14,798
2020-03-04,WA,626,417,16,1043
2020-03-05,WA,731,672,20,1403
2020-03-06,WA,813,1066,26,1879
2020-03-07,WA,912,1370,27,2282
2020-03-08,WA,1065,1740,31,2805
2020-03-09,WA,1237,2592,35,3829
2020-03-10,WA,1453,4160,37,5613
2020-03-11,WA,1665,6215,40,7880
2020-03-12,WA,1921,9723,44,11644
2020-03-13,WA,2218,13660,47,15878
2020-03-14,WA,2484,15723,51,18207
2020-03-15,WA,2738,17158,57,19896
2020-03-16,WA,3107,21684,69,24791
2020-03-17,WA,3432,25997,78,29429
2020-03-18,WA,3810,30359,82,34169
2020-03-19,WA,4146,34573,92,38719
2020-03-20,WA,4551,38229,104,42780
2020-03-21,WA,4837,40285,111,45122
2020-03-22,WA,5121,41889,126,47010
2020-03-23,WA,5568,46745,137,52313
2020-03-24,WA,5923,51617,146,57540
2020-03-25,WA,6329,56218,159,62547
2020-03-26,WA,6700,60318,183,67018
2020-03-27,WA,7076,64302,199,71378
2020-03-28,WA,7397,66582,220,73979
2020-03-29,WA,7715,68097,237,75812
2020-03-30,WA,8120,72842,248,80962
2020-03-31,WA,8431,77237,262,85668
2020-04-01,WA,8869,81516,282,90385
2020-04-02,WA,9201,86091,310,95292
2020-04-03,WA,9485,90661,338,100146
2020-04-04,WA,9732,93028,365,102760
2020-04-05,WA,9953,94759,386,104712
2020-04-06,WA,10282,99566,407,109848
2020-04-07,WA,10547,104530,429,115077
2020-04-08,WA,10831,109050,443,119881
2020-04-09,WA,11118,113069,459,124187
2020-04-10,WA,11395,117091,476,128486
2020-04-11,WA,11605,118957,494,130562
2020-04-12,WA,11775,120218,509,131993
2020-04-13,WA,12079,124134,526,136213
2020-04-14,WA,12303,128219,542,140522
2020-04-15,WA,12619,132049,551,144668
2020-04-16,WA,12872,136144,571,149016
2020-04-17,WA,13174,140294,585,153468
2020-04-18,WA,13407,142307,598,155714
2020-04-19,WA,13583,143808,615,157391
2020-04-20,WA,13890,147889,629,161779
2020-04-21,WA,14133,151848,640,165981
2020-04-22,WA,14375,156030,647,170405
2020-04-23,WA,14628,160115,654,174743
2020-04-24,WA,14913,165339,659,180252
2020-04-25,WA,15110,168153,665,183263
2020-04-26,WA,15292,169749,738,185041
2020-04-27,WA,15566,174592,749,190158
2020-04-28,WA,15798,179707,765,195505
2020-04-29,WA,16042,184386,786,200428
2020-04-30,WA,16309,189001,801,205310
2020-05-01,WA,16653,193449,814,210102
2020-05-02,WA,16802,195619,824,212421
2020-05-03,WA,16943,196962,830,213905
2020-05-04,WA,17209,202206,834,219415
2020-05-05,WA,17470,207014,841,224484
2020-05-06,WA,17718,212065,862,229783
2020-05-07,WA,17914,216453,870,234367
2020-05-08,WA,18124,221418,891,239542
2020-05-09,WA,18275,223361,905,241636
2020-05-10,WA,18449,224548,921,242997
2020-05-11,WA,18741,229099,931,247840
2020-05-12,WA,18952,233864,945,252816
2020-05-13,WA,19179,238384,962,257563
2020-05-14,WA,19424,243144,975,262568
2020-05-15,WA,19650,248322,983,267972
2020-05-16,WA,19838,250963,992,270801
2020-05-17,WA,19991,252780,1000,272771
2020-05-18,WA,20286,259467,1001,279753
2020-05-19,WA,20535,266314,1002,286849
2020-05-20,WA,20784,271703,1031,292487
2020-05-21,WA,20988,276171,1037,297159
2020-05-22,WA,21283,280444,1044,301727
2020-05-23,WA,21492,282906,1050,304398
2020-05-24,WA,21652,285088,1055,306740
2020-05-25,WA,21909,287314,1061,309223
2020-05-26,WA,22184,293934,1070,316118
2020-05-27,WA,22483,299378,1078,321861
2020-05-28,WA,22753,304340,1095,327093
2020-05-29,WA,23047,309438,1106,332485
2020-05-30,WA,23275,312508,1111,335783
2020-05-31,WA,23456,314671,1118,338127
2020-06-01,WA,23798,320527,1118,344325
2020-06-02,WA,24086,326646,1124,350732
2020-06-03,WA,24385,331675,1129,356060
2020-06-04,WA,24677,335972,1135,360649
2020-06-05,WA,25023,341885,1138,366908
2020-06-06,WA,25227,345430,1149,370657
2020-06-07,WA,25419,347610,1153,373029
2020-06-08,WA,25732,355573,1159,381305
2020-06-09,WA,26004,365086,1161,391090
2020-06-10,WA,26281,376364,1176,402645
2020-06-11,WA,26559,387295,1190,413854
2020-06-12,WA,26825,396220,1194,423045
2020-06-13,WA,26985,402149,1204,429134
2020-06-14,WA,27095,405799,1213,432894
2020-06-15,WA,27493,416076,1217,443569
2020-06-16,WA,27925,426586,1221,454511
2020-06-17,WA,28255,435169,1231,463424
2020-06-18,WA,28575,441468,1226,470043
2020-06-19,WA,28666,445796,1245,474462
2020-06-20,WA,28680,446471,1255,475151
2020-06-21,WA,28225,437844,1265,466069
2020-06-22,WA,28680,446258,1270,474938
2020-06-23,WA,28870,448334,1276,477204
2020-06-24,WA,29386,457673,1284,487059
2020-06-25,WA,29869,465629,1293,495498
2020-06-26,WA,30367,475428,1300,505795
2020-06-27,WA,30855,483573,1304,514428
2020-06-28,WA,31404,494398,1310,525802
2020-06-29,WA,31752,502691,1310,534443
2020-06-30,WA,32253,515967,1320,548220
2020-07-01,WA,32824,524451,1332,557275
2020-07-02,WA,33435,538529,1339,571964
2020-07-03,WA,34151,550838,1342,584989
2020-07-04,WA,34778,565197,1352,599975
2020-07-05,WA,35247,572029,1354,607276
2020-07-06,WA,35898,576808,1359,612706
2020-07-07,WA,36985,592271,1370,629256
2020-07-08,WA,37420,598104,1384,635524
2020-07-09,WA,37941,607131,1394,645072
2020-07-10,WA,38581,621749,1409,660330
2020-07-11,WA,39218,629248,1424,668466
2020-07-12,WA,39218,629248,1424,668466
2020-07-13,WA,40656,645349,1438,686005
2020-07-14,WA,41757,666517,1399,708274
2020-07-15,WA,42304,675930,1404,718234
2020-07-16,WA,43046,690840,1421,733886
2020-07-17,WA,44313,708861,1427,753174
2020-07-18,WA,45067,722590,1434,767657
2020-07-19,WA,46026,745760,1444,791786
2020-07-20,WA,46946,762393,1447,809339
2020-07-21,WA,47743,778611,1453,826354
2020-07-22,WA,48575,792609,1465,841184
2020-07-23,WA,49247,805905,1468,855152
2020-03-04,WI,1,19,0,20
2020-03-05,WI,1,19,0,20
2020-03-06,WI,1,31,0,32
2020-03-07,WI,1,31,0,32
2020-03-08,WI,1,31,0,32
2020-03-09,WI,1,36,0,37
2020-03-10,WI,2,36,0,38
2020-03-11,WI,3,43,0,46
2020-03-12,WI,9,84,0,93
2020-03-13,WI,23,169,0,192
2020-03-14,WI,23,169,0,192
2020-03-15,WI,37,313,0,350
2020-03-16,WI,56,504,0,560
2020-03-17,WI,83,1038,0,1121
2020-03-18,WI,121,1577,0,1698
2020-03-19,WI,174,2192,0,2366
2020-03-20,WI,235,3455,3,3690
2020-03-21,WI,315,4628,4,4943
2020-03-22,WI,425,6230,4,6655
2020-03-23,WI,466,7050,5,7516
2020-03-24,WI,525,8237,5,8762
2020-03-25,WI,667,10089,7,10756
2020-03-26,WI,806,11583,8,12389
2020-03-27,WI,969,13140,13,14109
2020-03-28,WI,1134,15232,13,16366
2020-03-29,WI,1276,16550,13,17826
2020-03-30,WI,1422,15856,14,17278
2020-03-31,WI,1585,17375,16,18960
2020-04-01,WI,1821,18819,24,20640
2020-04-02,WI,2040,20317,31,22357
2020-04-03,WI,2263,22377,37,24640
2020-04-04,WI,2476,23859,56,26335
2020-04-05,WI,2643,25169,68,27812
2020-04-06,WI,2866,26574,77,29440
2020-04-07,WI,3064,28512,92,31576
2020-04-08,WI,3279,30115,99,33394
2020-04-09,WI,3443,31424,111,34867
2020-04-10,WI,3665,33225,128,36890
2020-04-11,WI,3822,34680,137,38502
2020-04-12,WI,3964,35916,144,39880
2020-04-13,WI,4080,36769,154,40849
2020-04-14,WI,4246,37997,170,42243
2020-04-15,WI,4453,39326,182,43779
2020-04-16,WI,4636,40974,197,45610
2020-04-17,WI,4839,42365,205,47204
2020-04-18,WI,5013,43962,211,48975
2020-04-19,WI,5176,45323,220,50499
2020-04-20,WI,5353,46603,230,51956
2020-04-21,WI,5509,47841,242,53350
2020-04-22,WI,5766,49502,246,55268
2020-04-23,WI,6011,51456,257,57467
2020-04-24,WI,6364,54573,262,60937
2020-04-25,WI,6715,57138,266,63853
2020-04-26,WI,6963,59235,272,66198
2020-04-27,WI,7161,61311,281,68472
2020-04-28,WI,7391,63535,300,70926
2020-04-29,WI,7660,66630,308,74290
2020-04-30,WI,8052,69394,316,77446
2020-05-01,WI,8550,72566,327,81116
2020-05-02,WI,8920,75570,334,84490
2020-05-03,WI,9227,77997,339,87224
2020-05-04,WI,9538,80467,340,90005
2020-05-05,WI,9896,83967,353,93863
2020-05-06,WI,10262,87826,362,98088
2020-05-07,WI,10621,93035,374,103656
2020-05-08,WI,11030,97265,384,108295
2020-05-09,WI,11402,101935,398,113337
2020-05-10,WI,11694,105163,400,116857
2020-05-11,WI,11920,108033,409,119953
2020-05-12,WI,12131,112748,418,124879
2020-05-13,WI,12449,117111,421,129560
2020-05-14,WI,12869,122598,434,135467
2020-05-15,WI,13344,128657,445,142001
2020-05-16,WI,13878,134206,453,148084
2020-05-17,WI,14257,139674,453,153931
2020-05-18,WI,14442,144502,459,158944
2020-05-19,WI,14692,148237,467,162929
2020-05-20,WI,15269,154300,481,169569
2020-05-21,WI,15792,163238,487,179030
2020-05-22,WI,16340,172703,496,189043
2020-05-23,WI,16843,179329,507,196172
2020-05-24,WI,17253,186206,510,203459
2020-05-25,WI,17571,193379,514,210950
2020-05-26,WI,17867,200874,517,218741
2020-05-27,WI,18513,210605,539,229118
2020-05-28,WI,19077,220719,550,239796
2020-05-29,WI,19843,233588,568,253431
2020-05-30,WI,20382,242908,588,263290
2020-05-31,WI,20564,250103,592,270667
2020-06-01,WI,20736,253595,595,274331
2020-06-02,WI,21155,263743,607,284898
2020-06-03,WI,21661,279711,616,301372
2020-06-04,WI,22193,291367,626,313560
2020-06-05,WI,22599,303332,633,325931
2020-06-06,WI,22937,314802,645,337739
2020-06-07,WI,23212,325867,647,349079
2020-06-08,WI,23434,333253,646,356687
2020-06-09,WI,23734,347210,661,370944
2020-06-10,WI,24070,357112,671,381182
2020-06-11,WI,24441,366054,682,390495
2020-06-12,WI,24795,377362,689,402157
2020-06-13,WI,25089,388399,691,413488
2020-06-14,WI,25340,397366,692,422706
2020-06-15,WI,25546,403447,694,428993
2020-06-16,WI,25844,414330,703,440174
2020-06-17,WI,26129,423736,712,449865
2020-06-18,WI,26590,433913,719,460503
2020-06-19,WI,26913,444751,730,471664
2020-06-20,WI,27326,454563,744,481889
2020-06-21,WI,27615,460334,744,487949
2020-06-22,WI,27878,466634,745,494512
2020-06-23,WI,28175,478165,750,506340
2020-06-24,WI,28641,487803,757,516444
2020-06-25,WI,29105,498561,766,527666
2020-06-26,WI,29668,507168,766,536836
2020-06-27,WI,30227,515723,777,545950
2020-06-28,WI,30707,521747,777,552454
2020-06-29,WI,31033,527359,784,558392
2020-06-30,WI,31662,539539,784,571201
2020-07-01,WI,32225,551607,793,583832
2020-07-02,WI,32809,563946,800,596755
2020-07-03,WI,33431,573553,803,606984
2020-07-04,WI,34207,579637,803,613844
2020-07-05,WI,34740,584111,803,618851
2020-07-06,WI,35230,588913,803,624143
2020-07-07,WI,35765,601012,812,636777
2020-07-08,WI,36410,611150,814,647560
2020-07-09,WI,37210,623554,816,660764
2020-07-10,WI,38099,635411,821,673510
2020-07-11,WI,39080,646504,828,685584
2020-07-12,WI,39877,653352,827,693229
2020-07-13,WI,40382,659479,827,699861
2020-07-14,WI,41349,673195,833,714544
2020-07-15,WI,42197,686299,834,728496
2020-07-16,WI,43139,699670,838,742809
2020-07-17,WI,44068,712197,840,756265
2020-07-18,WI,45099,723643,850,768742
2020-07-19,WI,45948,730902,851,776850
2020-07-20,WI,46675,737191,853,783866
2020-07-21,WI,47836,750562,866,798398
2020-07-22,WI,48583,764630,872,813213
2020-07-23,WI,49669,778842,885,828511
2020-03-06,WV,0,1,0,1
2020-03-07,WV,0,2,0,2
2020-03-08,WV,0,2,0,2
2020-03-09,WV,0,2,0,2
2020-03-10,WV,0,2,0,2
2020-03-11,WV,0,3,0,3
2020-03-12,WV,0,7,0,7
2020-03-13,WV,0,17,0,17
2020-03-14,WV,0,26,0,26
2020-03-15,WV,0,38,0,38
2020-03-16,WV,0,80,0,80
2020-03-17,WV,0,80,0,80
2020-03-18,WV,1,122,0,123
2020-03-19,WV,2,143,0,145
2020-03-20,WV,7,219,0,226
2020-03-21,WV,11,330,0,341
2020-03-22,WV,12,385,0,397
2020-03-23,WV,16,444,0,460
2020-03-24,WV,20,610,0,630
2020-03-25,WV,39,759,0,798
2020-03-26,WV,51,1031,0,1082
2020-03-27,WV,76,1779,0,1855
2020-03-28,WV,96,2331,0,2427
2020-03-29,WV,113,2705,0,2818
2020-03-30,WV,126,2984,1,3110
2020-03-31,WV,162,3981,1,4143
2020-04-01,WV,191,4384,1,4575
2020-04-02,WV,217,5276,2,5493
2020-04-03,WV,237,6130,2,6367
2020-04-04,WV,282,7404,2,7686
2020-04-05,WV,324,8514,3,8838
2020-04-06,WV,345,9595,4,9940
2020-04-07,WV,412,11647,4,12059
2020-04-08,WV,462,12083,4,12545
2020-04-09,WV,523,13340,5,13863
2020-04-10,WV,554,14001,5,14555
2020-04-11,WV,577,14875,5,15452
2020-04-12,WV,611,15646,8,16257
2020-04-13,WV,626,16029,9,16655
2020-04-14,WV,640,16398,9,17038
2020-04-15,WV,702,16954,10,17656
2020-04-16,WV,739,17567,13,18306
2020-04-17,WV,754,17927,13,18681
2020-04-18,WV,785,18655,16,19440
2020-04-19,WV,863,19168,18,20031
2020-04-20,WV,902,21253,24,22155
2020-04-21,WV,914,21849,26,22763
2020-04-22,WV,939,24897,26,25836
2020-04-23,WV,967,26938,29,27905
2020-04-24,WV,988,28823,32,29811
2020-04-25,WV,1020,31946,32,32966
2020-04-26,WV,1044,38019,34,39063
2020-04-27,WV,1063,41976,36,43039
2020-04-28,WV,1079,41976,37,43055
2020-04-29,WV,1095,41976,38,43071
2020-04-30,WV,1118,43423,41,44541
2020-05-01,WV,1136,45708,46,46844
2020-05-02,WV,1169,47977,48,49146
2020-05-03,WV,1191,50447,50,51638
2020-05-04,WV,1206,52033,50,53239
2020-05-05,WV,1238,53585,50,54823
2020-05-06,WV,1248,54536,50,55784
2020-05-07,WV,1287,56234,51,57521
2020-05-08,WV,1310,58126,51,59436
2020-05-09,WV,1335,59662,53,60997
2020-05-10,WV,1360,61284,54,62644
2020-05-11,WV,1366,62103,54,63469
2020-05-12,WV,1371,63698,57,65069
2020-05-13,WV,1398,65282,58,66680
2020-05-14,WV,1427,67286,60,68713
2020-05-15,WV,1441,69495,62,70936
2020-05-16,WV,1457,71936,64,73393
2020-05-17,WV,1490,74000,67,75490
2020-05-18,WV,1491,74544,67,76035
2020-05-19,WV,1509,76792,68,78301
2020-05-20,WV,1545,79096,69,80641
2020-05-21,WV,1593,81548,70,83141
2020-05-22,WV,1616,83213,71,84829
2020-05-23,WV,1717,82027,72,83744
2020-05-24,WV,1759,83935,72,85694
2020-05-25,WV,1774,84551,72,86325
2020-05-26,WV,1854,85957,74,87811
2020-05-27,WV,1867,86594,74,88461
2020-05-28,WV,1906,88409,74,90315
2020-05-29,WV,1951,91426,74,93377
2020-05-30,WV,1974,93916,75,95890
2020-05-31,WV,2010,95612,75,97622
2020-06-01,WV,2017,96078,75,98095
2020-06-02,WV,2041,98502,77,100543
2020-06-03,WV,2071,101697,78,103768
2020-06-04,WV,2092,103957,78,106049
2020-06-05,WV,2119,106399,84,108518
2020-06-06,WV,2131,107592,84,109723
2020-06-07,WV,2144,109663,84,111807
2020-06-08,WV,2153,111452,84,113605
2020-06-09,WV,2169,112169,84,114338
2020-06-10,WV,2188,115802,85,117990
2020-06-11,WV,2212,118908,85,121120
2020-06-12,WV,2233,121806,86,124039
2020-06-13,WV,2259,125258,88,127517
2020-06-14,WV,2289,128910,88,131199
2020-06-15,WV,2298,129655,88,131953
2020-06-16,WV,2341,134730,88,137071
2020-06-17,WV,2376,138994,88,141370
2020-06-18,WV,2418,142011,88,144429
2020-06-19,WV,2435,143579,88,146014
2020-06-20,WV,2486,145910,88,148396
2020-06-21,WV,2543,148046,89,150589
2020-06-22,WV,2552,148652,89,151204
2020-06-23,WV,2582,151746,92,154328
2020-06-24,WV,2629,154419,92,157048
2020-06-25,WV,2661,156043,92,158704
2020-06-26,WV,2712,159245,92,161957
2020-06-27,WV,2761,161894,93,164655
2020-06-28,WV,2817,163691,93,166508
2020-06-29,WV,2870,166785,93,169655
2020-06-30,WV,2905,168859,93,171764
2020-07-01,WV,2932,170420,93,173352
2020-07-02,WV,3053,175288,93,178341
2020-07-03,WV,3126,177576,93,180702
2020-07-04,WV,3141,178288,94,181429
2020-07-05,WV,3262,181559,94,184821
2020-07-06,WV,3442,185539,95,188981
2020-07-07,WV,3461,186386,95,189847
2020-07-08,WV,3707,190208,95,193915
2020-07-09,WV,3826,193363,95,197189
2020-07-10,WV,3983,197220,95,201203
2020-07-11,WV,4074,199749,95,203823
2020-07-12,WV,4207,202829,96,207036
2020-07-13,WV,4259,203966,96,208225
2020-07-14,WV,4407,209605,97,214012
2020-07-15,WV,4557,213347,97,217904
2020-07-16,WV,4657,214517,99,219174
2020-07-17,WV,4783,217769,100,222552
2020-07-18,WV,4894,220617,100,225511
2020-07-19,WV,5042,225946,100,230988
2020-07-20,WV,5142,229838,100,234980
2020-07-21,WV,5199,235127,101,240326
2020-07-22,WV,5206,237181,101,242387
2020-07-23,WV,5550,245522,103,251072
2020-03-07,WY,0,0,0,0
2020-03-08,WY,0,0,0,0
2020-03-09,WY,0,0,0,0
2020-03-10,WY,0,0,0,0
2020-03-11,WY,0,0,0,0
2020-03-12,WY,1,0,0,1
2020-03-13,WY,1,0,0,1
2020-03-14,WY,2,0,0,2
2020-03-15,WY,3,0,0,3
2020-03-16,WY,3,0,0,3
2020-03-17,WY,10,95,0,105
2020-03-18,WY,15,178,0,193
2020-03-19,WY,18,271,0,289
2020-03-20,WY,19,331,0,350
2020-03-21,WY,23,438,0,461
2020-03-22,WY,24,438,0,462
2020-03-23,WY,26,592,0,618
2020-03-24,WY,29,710,0,739
2020-03-25,WY,44,954,0,998
2020-03-26,WY,53,1052,0,1105
2020-03-27,WY,70,1211,0,1281
2020-03-28,WY,82,1475,0,1557
2020-03-29,WY,86,1554,0,1640
2020-03-30,WY,94,1840,0,1934
2020-03-31,WY,109,1999,0,2108
2020-04-01,WY,130,2218,0,2348
2020-04-02,WY,150,2439,0,2589
2020-04-03,WY,162,2704,0,2866
2020-04-04,WY,187,2945,0,3132
2020-04-05,WY,197,3040,0,3237
2020-04-06,WY,210,3719,0,3929
2020-04-07,WY,216,3789,0,4005
2020-04-08,WY,221,3843,0,4064
2020-04-09,WY,230,3920,0,4150
2020-04-10,WY,253,4736,0,4989
2020-04-11,WY,261,5198,0,5459
2020-04-12,WY,261,5198,0,5459
2020-04-13,WY,275,5689,1,5964
2020-04-14,WY,275,5689,1,5964
2020-04-15,WY,287,6042,2,6329
2020-04-16,WY,296,6131,2,6427
2020-04-17,WY,296,6131,2,6427
2020-04-18,WY,305,6217,2,6522
2020-04-19,WY,309,6972,2,7281
2020-04-20,WY,313,7073,2,7386
2020-04-21,WY,320,7301,6,7621
2020-04-22,WY,322,7301,6,7623
2020-04-23,WY,326,7241,7,7567
2020-04-24,WY,349,7696,7,8045
2020-04-25,WY,349,7797,7,8146
2020-04-26,WY,362,7797,7,8159
2020-04-27,WY,370,7797,7,8167
2020-04-28,WY,389,8226,7,8615
2020-04-29,WY,536,8681,7,9217
2020-04-30,WY,544,8902,7,9446
2020-05-01,WY,559,9136,7,9695
2020-05-02,WY,566,9463,7,10029
2020-05-03,WY,579,9640,7,10219
2020-05-04,WY,586,9868,7,10454
2020-05-05,WY,596,10319,7,10915
2020-05-06,WY,604,11403,7,12007
2020-05-07,WY,631,11403,7,12034
2020-05-08,WY,635,11403,7,12038
2020-05-09,WY,644,11403,7,12047
2020-05-10,WY,661,11403,7,12064
2020-05-11,WY,662,11403,7,12065
2020-05-12,WY,675,14384,7,15059
2020-05-13,WY,675,14384,7,15059
2020-05-14,WY,701,14729,7,15430
2020-05-15,WY,715,15307,7,16022
2020-05-16,WY,716,15678,7,16394
2020-05-17,WY,754,16331,8,17085
2020-05-18,WY,754,16331,8,17085
2020-05-19,WY,766,17084,10,17850
2020-05-20,WY,787,18053,11,18840
2020-05-21,WY,787,18053,11,18840
2020-05-22,WY,803,18621,12,19424
2020-05-23,WY,813,19221,12,20034
2020-05-24,WY,813,19221,12,20034
2020-05-25,WY,838,19551,12,20389
2020-05-26,WY,850,20652,13,21502
2020-05-27,WY,850,20652,13,21502
2020-05-28,WY,874,22286,15,23160
2020-05-29,WY,891,22378,15,23269
2020-05-30,WY,898,23185,16,24083
2020-05-31,WY,903,23490,16,24393
2020-06-01,WY,910,24237,17,25147
2020-06-02,WY,910,24832,17,25742
2020-06-03,WY,915,25713,17,26628
2020-06-04,WY,915,26074,17,26989
2020-06-05,WY,933,26679,17,27612
2020-06-06,WY,939,27569,17,28508
2020-06-07,WY,947,27804,17,28751
2020-06-08,WY,960,29014,17,29974
2020-06-09,WY,970,29366,17,30336
2020-06-10,WY,980,29872,18,30852
2020-06-11,WY,1009,30609,18,31618
2020-06-12,WY,1027,30873,18,31900
2020-06-13,WY,1050,32005,18,33055
2020-06-14,WY,1060,32005,18,33065
2020-06-15,WY,1060,31546,18,32606
2020-06-16,WY,1089,33324,18,34413
2020-06-17,WY,1114,33955,18,35069
2020-06-18,WY,1144,35010,18,36154
2020-06-19,WY,1173,35301,20,36474
2020-06-20,WY,1179,26162,20,27341
2020-06-21,WY,1197,26162,20,27359
2020-06-22,WY,1230,26162,20,27392
2020-06-23,WY,1254,27485,20,28739
2020-06-24,WY,1279,28869,20,30148
2020-06-25,WY,1326,28869,20,30195
2020-06-26,WY,1368,30406,20,31774
2020-06-27,WY,1392,30406,20,31798
2020-06-28,WY,1417,30406,20,31823
2020-06-29,WY,1450,30406,20,31856
2020-06-30,WY,1487,32185,20,33672
2020-07-01,WY,1514,32185,20,33699
2020-07-02,WY,1550,33693,20,35243
2020-07-03,WY,1582,33693,20,35275
2020-07-04,WY,1606,33693,20,35299
2020-07-05,WY,1634,33693,20,35327
2020-07-06,WY,1634,33693,20,35327
2020-07-07,WY,1711,36078,20,37789
2020-07-08,WY,1740,36078,21,37818
2020-07-09,WY,1774,37271,21,39045
2020-07-10,WY,1790,38077,21,39867
2020-07-11,WY,1839,38077,21,39916
2020-07-12,WY,1862,38077,21,39939
2020-07-13,WY,1862,38077,21,39939
2020-07-14,WY,1951,38077,22,40028
2020-07-15,WY,1985,40929,22,42914
2020-07-16,WY,2026,41426,24,43452
2020-07-17,WY,2069,41927,24,43996
2020-07-18,WY,2108,41927,24,44035
2020-07-19,WY,2126,41927,24,44053
2020-07-20,WY,2187,41927,24,44114
2020-07-21,WY,2238,41927,25,44165
2020-07-22,WY,2288,41927,25,44215
2020-07-23,WY,2346,45823,25,48169
