date,state,positive,negative,totalTestResults,death
2020-03-06,AK,0,8,8,0
2020-03-07,AK,0,12,12,0
2020-03-08,AK,0,14,14,0
2020-03-09,AK,0,23,23,0
2020-03-10,AK,0,23,23,0
2020-03-11,AK,0,46,46,0
2020-03-12,AK,0,46,46,0
2020-03-13,AK,1,59,60,0
2020-03-14,AK,1,143,144,0
2020-03-15,AK,1,143,144,0
2020-03-16,AK,1,143,144,0
2020-03-17,AK,3,334,337,0
2020-03-18,AK,6,406,412,0
2020-03-19,AK,6,432,438,0
2020-03-20,AK,12,686,698,0
2020-03-21,AK,14,758,772,0
2020-03-22,AK,22,946,968,0
2020-03-23,AK,22,946,968,0
2020-03-24,AK,36,986,1022,0
2020-03-25,AK,42,1649,1691,1
2020-03-26,AK,59,1801,1860,1
2020-03-27,AK,69,2319,2388,1
2020-03-28,AK,85,2836,2921,2
2020-03-29,AK,102,3232,3334,2
2020-03-30,AK,114,3540,3654,3
2020-03-31,AK,119,3594,3713,3
2020-04-01,AK,133,4470,4603,3
2020-04-02,AK,143,4879,5022,3
2020-04-03,AK,157,5859,6016,3
2020-04-04,AK,171,5869,6040,5
2020-04-05,AK,185,6099,6284,6
2020-04-06,AK,191,6692,6883,6
2020-04-07,AK,213,6700,6913,6
2020-04-08,AK,226,6842,7068,7
2020-04-09,AK,235,6988,7223,7
2020-04-10,AK,246,7186,7432,7
2020-04-11,AK,257,7475,7732,8
2020-04-12,AK,272,7766,8038,8
2020-04-13,AK,277,7553,7830,8
2020-04-14,AK,285,8063,8348,9
2020-04-15,AK,293,8371,8664,9
2020-04-16,AK,300,8435,8735,9
2020-04-17,AK,309,9141,9450,9
2020-04-18,AK,314,9341,9655,9
2020-04-19,AK,319,9576,9895,9
2020-04-20,AK,321,9803,10124,9
2020-04-21,AK,329,10790,11119,9
2020-04-22,AK,335,11824,12159,9
2020-04-23,AK,337,11824,12161,9
2020-04-24,AK,339,11942,12281,9
2020-04-25,AK,339,15393,15732,9
2020-04-26,AK,341,15836,16177,9
2020-04-27,AK,345,15911,16256,9
2020-04-28,AK,351,16738,17089,9
2020-04-29,AK,355,18764,19119,9
2020-04-30,AK,355,18764,19119,9
2020-05-01,AK,364,19961,20325,9
2020-05-02,AK,365,21034,21399,9
2020-05-03,AK,368,21210,21578,9
2020-05-04,AK,370,21353,21723,9
2020-05-05,AK,371,22321,22692,9
2020-05-06,AK,372,23283,23655,10
2020-05-07,AK,374,23967,24341,10
2020-05-08,AK,377,25096,25473,10
2020-05-09,AK,378,26071,26449,10
2020-05-10,AK,379,26985,27364,10
2020-05-11,AK,381,28299,28680,10
2020-05-12,AK,383,29578,29961,10
2020-05-13,AK,383,30266,30649,10
2020-05-14,AK,387,31375,31762,10
2020-05-15,AK,388,32030,32418,10
2020-05-16,AK,392,32889,33281,10
2020-05-17,AK,396,34255,34651,10
2020-05-18,AK,399,35212,35611,10
2020-05-19,AK,399,35981,36380,10
2020-05-20,AK,402,36643,37045,10
2020-05-21,AK,402,39143,39545,10
2020-05-22,AK,404,41042,41446,10
2020-05-23,AK,408,41943,42351,10
2020-05-24,AK,408,43099,43507,10
2020-05-25,AK,409,44063,44472,10
2020-05-26,AK,411,44553,44964,10
2020-05-27,AK,412,45951,46363,10
2020-05-28,AK,425,47545,47970,10
2020-05-29,AK,430,49009,49439,10
2020-05-30,AK,434,51261,51695,10
2020-05-31,AK,434,51261,51695,10
2020-06-01,AK,467,53723,54190,10
2020-06-02,AK,487,55716,56203,10
2020-06-03,AK,505,57677,58182,10
2020-06-04,AK,513,59584,60097,10
2020-06-05,AK,524,60466,60990,10
2020-06-06,AK,536,63365,63901,10
2020-06-07,AK,544,64360,64904,10
2020-06-08,AK,563,65349,65912,10
2020-06-09,AK,573,66317,66890,11
2020-06-10,AK,593,67127,67720,11
2020-06-11,AK,611,68400,69011,11
2020-06-12,AK,625,70255,70880,12
2020-06-13,AK,654,71149,71803,12
2020-06-14,AK,661,72806,73467,12
2020-06-15,AK,664,73773,74437,12
2020-06-16,AK,676,75539,76215,12
2020-06-17,AK,696,77013,77709,12
2020-06-18,AK,708,80477,81185,12
2020-06-19,AK,722,82909,83631,12
2020-06-20,AK,743,86175,86918,12
2020-06-21,AK,755,87296,88051,12
2020-06-22,AK,761,90063,90824,12
2020-06-23,AK,778,92169,92947,12
2020-06-24,AK,792,95304,96096,12
2020-06-25,AK,816,98636,99452,12
2020-06-26,AK,836,100956,101792,14
2020-06-27,AK,854,104727,105581,14
2020-06-28,AK,883,107417,108300,14
2020-06-29,AK,904,107805,108709,14
2020-06-30,AK,940,111245,112185,14
2020-07-01,AK,978,113422,114400,14
2020-07-02,AK,1017,114892,115909,14
2020-07-03,AK,1063,119145,120208,15
2020-07-04,AK,1111,121621,122732,16
2020-07-05,AK,1138,122615,123753,16
2020-07-06,AK,1138,122615,123753,16
2020-07-07,AK,1184,130236,131420,17
2020-07-08,AK,1226,132175,133401,17
2020-07-09,AK,1272,134472,135744,17
2020-07-10,AK,1323,140608,141931,17
2020-07-11,AK,1385,141991,143376,17
2020-07-12,AK,1479,143996,145475,17
2020-07-13,AK,1539,145051,146590,17
2020-07-14,AK,1579,147894,149473,17
2020-07-15,AK,1631,154462,156093,17
2020-07-16,AK,2032,160990,163022,17
2020-07-17,AK,2081,163333,165414,17
2020-07-18,AK,2159,166204,168363,18
2020-07-19,AK,2277,170733,173010,18
2020-07-20,AK,2414,173172,175586,18
2020-07-21,AK,2525,176101,178626,18
2020-07-22,AK,2619,182714,185333,19
2020-07-23,AK,2684,186825,189509,19
2020-07-24,AK,2748,197824,200572,19
2020-07-25,AK,2868,202198,205066,20
2020-03-07,AL,0,0,0,0
2020-03-08,AL,0,0,0,0
2020-03-09,AL,0,0,0,0
2020-03-10,AL,0,0,0,0
2020-03-11,AL,0,10,10,0
2020-03-12,AL,0,10,10,0
2020-03-13,AL,1,11,12,0
2020-03-14,AL,6,22,28,0
2020-03-15,AL,12,28,40,0
2020-03-16,AL,28,28,56,0
2020-03-17,AL,36,28,64,0
2020-03-18,AL,46,28,74,0
2020-03-19,AL,68,28,96,0
2020-03-20,AL,81,28,109,0
2020-03-21,AL,124,28,152,0
2020-03-22,AL,138,1464,1602,0
2020-03-23,AL,167,1665,1832,0
2020-03-24,AL,215,2106,2321,0
2020-03-25,AL,283,2529,2812,0
2020-03-26,AL,506,3593,4099,1
2020-03-27,AL,587,4184,4771,3
2020-03-28,AL,696,4184,4880,3
2020-03-29,AL,806,4184,4990,4
2020-03-30,AL,859,5694,6553,6
2020-03-31,AL,981,6298,7279,13
2020-04-01,AL,1077,6697,7774,26
2020-04-02,AL,1233,7503,8736,32
2020-04-03,AL,1432,8187,9619,35
2020-04-04,AL,1580,9273,10853,43
2020-04-05,AL,1796,11282,13078,45
2020-04-06,AL,1968,12797,14765,50
2020-04-07,AL,2119,12797,14916,56
2020-04-08,AL,2369,16753,19122,66
2020-04-09,AL,2769,18058,20827,74
2020-04-10,AL,2968,18058,21026,80
2020-04-11,AL,3191,18058,21249,91
2020-04-12,AL,3525,18058,21583,93
2020-04-13,AL,3734,25448,29182,99
2020-04-14,AL,3876,29241,33117,110
2020-04-15,AL,4113,29964,34077,121
2020-04-16,AL,4345,32046,36391,133
2020-04-17,AL,4530,33318,37848,144
2020-04-18,AL,4655,37883,42538,146
2020-04-19,AL,4837,40875,45712,154
2020-04-20,AL,5025,40875,45900,167
2020-04-21,AL,5231,43295,48526,177
2020-04-22,AL,5465,43295,48760,194
2020-04-23,AL,5778,46863,52641,197
2020-04-24,AL,5832,46863,52695,197
2020-04-25,AL,6137,65207,71344,212
2020-04-26,AL,6270,67281,73551,216
2020-04-27,AL,6499,67498,73997,222
2020-04-28,AL,6687,69140,75827,242
2020-04-29,AL,6842,73607,80449,245
2020-04-30,AL,7019,80177,87196,269
2020-05-01,AL,7158,84775,91933,279
2020-05-02,AL,7434,84775,92209,288
2020-05-03,AL,7725,84775,92500,290
2020-05-04,AL,8025,95092,103117,296
2020-05-05,AL,8285,98481,106766,313
2020-05-06,AL,8581,100935,109516,340
2020-05-07,AL,8898,106275,115173,349
2020-05-08,AL,9221,110893,120114,375
2020-05-09,AL,9567,115927,125494,388
2020-05-10,AL,9777,117644,127421,393
2020-05-11,AL,10009,119435,129444,401
2020-05-12,AL,10310,122908,133218,429
2020-05-13,AL,10617,125755,136372,449
2020-05-14,AL,10968,131017,141985,467
2020-05-15,AL,11216,134847,146063,476
2020-05-16,AL,11523,141971,153494,485
2020-05-17,AL,11771,144579,156350,488
2020-05-18,AL,12086,145037,157123,489
2020-05-19,AL,12376,145190,157566,504
2020-05-20,AL,12744,151706,164450,517
2020-05-21,AL,13119,157620,170739,529
2020-05-22,AL,13563,164205,177768,537
2020-05-23,AL,13938,168738,182676,546
2020-05-24,AL,14327,171472,185799,551
2020-05-25,AL,14730,175585,190315,562
2020-05-26,AL,15396,178363,193759,575
2020-05-27,AL,15843,179951,195794,581
2020-05-28,AL,16310,184171,200481,590
2020-05-29,AL,16823,192060,208883,605
2020-05-30,AL,17359,194842,212201,618
2020-05-31,AL,17903,199650,217553,631
2020-06-01,AL,18363,205160,223523,646
2020-06-02,AL,18642,205160,223802,651
2020-06-03,AL,18851,212743,231594,653
2020-06-04,AL,19072,216227,235299,653
2020-06-05,AL,19387,220086,239473,676
2020-06-06,AL,20043,225601,245644,689
2020-06-07,AL,20500,239066,259566,692
2020-06-08,AL,20925,239066,259991,718
2020-06-09,AL,21422,246317,267739,729
2020-06-10,AL,21989,251068,273057,744
2020-06-11,AL,22845,255981,278826,755
2020-06-12,AL,23710,262675,286385,769
2020-06-13,AL,24601,268651,293252,773
2020-06-14,AL,25615,271840,297455,773
2020-06-15,AL,26272,276402,302674,774
2020-06-16,AL,26912,278512,305424,785
2020-06-17,AL,27312,283411,310723,790
2020-06-18,AL,28206,294328,322534,810
2020-06-19,AL,29002,302323,331325,822
2020-06-20,AL,29549,309974,339523,838
2020-06-21,AL,30021,314657,344678,839
2020-06-22,AL,30454,318656,349110,841
2020-06-23,AL,31097,322941,354038,864
2020-06-24,AL,32064,326695,358759,891
2020-06-25,AL,33206,336252,369458,896
2020-06-26,AL,34183,344140,378323,907
2020-06-27,AL,35083,348943,384026,919
2020-06-28,AL,35441,350839,386280,919
2020-06-29,AL,37175,356118,393293,929
2020-06-30,AL,38045,368607,406652,950
2020-07-01,AL,38962,374991,413953,972
2020-07-02,AL,40111,379617,419728,985
2020-07-03,AL,41865,388766,430631,1006
2020-07-04,AL,42862,399226,442088,1007
2020-07-05,AL,43953,405933,449886,1007
2020-07-06,AL,44878,410217,455095,1007
2020-07-07,AL,45785,415579,461364,1033
2020-07-08,AL,46962,421330,468292,1058
2020-07-09,AL,49174,421330,470504,1068
2020-07-10,AL,50508,441708,492216,1104
2020-07-11,AL,51947,450073,502020,1114
2020-07-12,AL,53587,457919,511506,1121
2020-07-13,AL,55545,464059,519604,1124
2020-07-14,AL,57255,471834,529089,1164
2020-07-15,AL,59067,481982,541049,1211
2020-07-16,AL,61088,490021,551109,1230
2020-07-17,AL,63091,500024,563115,1265
2020-07-18,AL,65234,509261,574495,1286
2020-07-19,AL,67011,518522,585533,1287
2020-07-20,AL,68891,524897,593788,1291
2020-07-21,AL,70358,530023,600381,1303
2020-07-22,AL,71813,537675,609488,1364
2020-07-23,AL,74212,545315,619527,1397
2020-07-24,AL,76005,552979,628984,1438
2020-07-25,AL,78130,563481,641611,1456
2020-03-06,AR,0,6,6,0
2020-03-07,AR,0,6,6,0
2020-03-08,AR,0,6,6,0
2020-03-09,AR,0,12,12,0
2020-03-10,AR,0,12,12,0
2020-03-11,AR,0,12,12,0
2020-03-12,AR,6,24,30,0
2020-03-13,AR,9,30,39,0
2020-03-14,AR,12,65,77,0
2020-03-15,AR,16,103,119,0
2020-03-16,AR,22,132,154,0
2020-03-17,AR,22,197,219,0
2020-03-18,AR,33,236,269,0
2020-03-19,AR,46,310,356,0
2020-03-20,AR,96,351,447,0
2020-03-21,AR,118,567,685,0
2020-03-22,AR,165,711,876,0
2020-03-23,AR,174,906,1080,0
2020-03-24,AR,218,947,1165,0
2020-03-25,AR,280,1437,1717,2
2020-03-26,AR,335,1504,1839,3
2020-03-27,AR,381,1545,1926,3
2020-03-28,AR,404,2938,3342,5
2020-03-29,AR,426,3027,3453,6
2020-03-30,AR,473,5262,5735,7
2020-03-31,AR,523,5959,6482,8
2020-04-01,AR,584,7354,7938,10
2020-04-02,AR,643,7880,8523,12
2020-04-03,AR,704,8995,9699,12
2020-04-04,AR,743,9627,10370,14
2020-04-05,AR,830,10412,11242,16
2020-04-06,AR,875,11970,12845,16
2020-04-07,AR,946,12692,13638,16
2020-04-08,AR,1000,13530,14530,18
2020-04-09,AR,1119,13832,14951,21
2020-04-10,AR,1171,15949,17120,23
2020-04-11,AR,1226,17352,18578,24
2020-04-12,AR,1280,18442,19722,27
2020-04-13,AR,1410,19394,20804,30
2020-04-14,AR,1480,19651,21131,30
2020-04-15,AR,1569,20265,21834,33
2020-04-16,AR,1620,21055,22675,37
2020-04-17,AR,1695,21799,23494,37
2020-04-18,AR,1739,22402,24141,38
2020-04-19,AR,1781,22428,24209,40
2020-04-20,AR,1923,24630,26553,42
2020-04-21,AR,2227,25214,27441,43
2020-04-22,AR,2276,27437,29713,42
2020-04-23,AR,2465,29125,31590,45
2020-04-24,AR,2741,32837,35578,45
2020-04-25,AR,2829,35224,38053,47
2020-04-26,AR,2941,36528,39469,49
2020-04-27,AR,3017,37440,40457,50
2020-04-28,AR,3111,37560,40671,52
2020-04-29,AR,3192,42257,45449,59
2020-04-30,AR,3255,45124,48379,61
2020-05-01,AR,3321,46355,49676,64
2020-05-02,AR,3372,48210,51582,73
2020-05-03,AR,3431,49459,52890,76
2020-05-04,AR,3458,50984,54442,81
2020-05-05,AR,3496,51139,54635,83
2020-05-06,AR,3568,55435,59003,85
2020-05-07,AR,3611,56384,59995,87
2020-05-08,AR,3694,60300,63994,88
2020-05-09,AR,3747,61781,65528,88
2020-05-10,AR,3747,61781,65528,88
2020-05-11,AR,4034,64996,69030,94
2020-05-12,AR,4164,66280,70444,95
2020-05-13,AR,4164,69051,73215,95
2020-05-14,AR,4236,71582,75818,97
2020-05-15,AR,4463,77066,81529,98
2020-05-16,AR,4578,77066,81644,98
2020-05-17,AR,4759,80426,85185,98
2020-05-18,AR,4813,80426,85239,100
2020-05-19,AR,4923,88778,93701,102
2020-05-20,AR,5003,91255,96258,107
2020-05-21,AR,5458,93818,99276,110
2020-05-22,AR,5612,97435,103047,113
2020-05-23,AR,5612,97435,103047,113
2020-05-24,AR,5922,102659,108581,116
2020-05-25,AR,6029,105593,111622,117
2020-05-26,AR,6180,105593,111773,119
2020-05-27,AR,6277,109319,115596,120
2020-05-28,AR,6538,112364,118902,120
2020-05-29,AR,6538,113230,119768,125
2020-05-30,AR,7013,119484,126497,133
2020-05-31,AR,7253,122262,129515,133
2020-06-01,AR,7443,125793,133236,133
2020-06-02,AR,7443,125793,133236,133
2020-06-03,AR,8067,134413,142480,142
2020-06-04,AR,8067,134413,142480,142
2020-06-05,AR,8651,138960,147611,152
2020-06-06,AR,9101,147656,156757,154
2020-06-07,AR,9426,150847,160273,154
2020-06-08,AR,9740,150847,160587,155
2020-06-09,AR,10080,155701,165781,161
2020-06-10,AR,10368,165849,176217,165
2020-06-11,AR,10816,165849,176665,171
2020-06-12,AR,11547,169575,181122,176
2020-06-13,AR,11547,175470,187017,176
2020-06-14,AR,12501,184488,196989,179
2020-06-15,AR,12917,191221,204138,182
2020-06-16,AR,13191,192375,205566,182
2020-06-17,AR,13606,207093,220699,197
2020-06-18,AR,13928,214506,228434,208
2020-06-19,AR,14631,220141,234772,214
2020-06-20,AR,15142,227092,242234,224
2020-06-21,AR,15142,227092,242234,224
2020-06-22,AR,16083,240256,256339,227
2020-06-23,AR,16678,247814,264492,237
2020-06-24,AR,17375,254491,271866,240
2020-06-25,AR,18062,259318,277380,240
2020-06-26,AR,18062,259318,277380,240
2020-06-27,AR,18740,265225,283965,249
2020-06-28,AR,19310,271912,291222,259
2020-06-29,AR,20257,282279,302536,265
2020-06-30,AR,20777,290426,311203,270
2020-07-01,AR,21197,293661,314858,277
2020-07-02,AR,22075,301912,323987,279
2020-07-03,AR,22622,308615,331237,281
2020-07-04,AR,23209,315684,338893,286
2020-07-05,AR,23209,315684,338893,286
2020-07-06,AR,24253,320715,344968,292
2020-07-07,AR,24512,326143,350655,292
2020-07-08,AR,24512,328760,353272,301
2020-07-09,AR,26052,338609,364661,309
2020-07-10,AR,26803,338609,365412,313
2020-07-11,AR,26803,342846,369649,313
2020-07-12,AR,28367,354035,382402,321
2020-07-13,AR,28939,354035,382974,323
2020-07-14,AR,29733,360566,390299,331
2020-07-15,AR,30297,365479,395776,335
2020-07-16,AR,31114,369847,400961,341
2020-07-17,AR,31762,375735,407497,353
2020-07-18,AR,31762,381243,413005,353
2020-07-19,AR,32533,386638,419171,357
2020-07-20,AR,33927,398889,432816,357
2020-07-21,AR,34655,404980,439635,374
2020-07-22,AR,35246,404980,440226,380
2020-07-23,AR,36259,410221,446480,386
2020-07-24,AR,37249,424215,461464,394
2020-07-25,AR,37249,424215,461464,394
2020-03-16,AS,0,0,0,0
2020-03-17,AS,0,0,0,0
2020-03-18,AS,0,0,0,0
2020-03-19,AS,0,0,0,0
2020-03-20,AS,0,0,0,0
2020-03-21,AS,0,0,0,0
2020-03-22,AS,0,0,0,0
2020-03-23,AS,0,0,0,0
2020-03-24,AS,0,0,0,0
2020-03-25,AS,0,0,0,0
2020-03-26,AS,0,0,0,0
2020-03-27,AS,0,0,0,0
2020-03-28,AS,0,0,0,0
2020-03-29,AS,0,0,0,0
2020-03-30,AS,0,0,0,0
2020-03-31,AS,0,3,3,0
2020-04-01,AS,0,3,3,0
2020-04-02,AS,0,3,3,0
2020-04-03,AS,0,3,3,0
2020-04-04,AS,0,3,3,0
2020-04-05,AS,0,3,3,0
2020-04-06,AS,0,3,3,0
2020-04-07,AS,0,3,3,0
2020-04-08,AS,0,3,3,0
2020-04-09,AS,0,3,3,0
2020-04-10,AS,0,3,3,0
2020-04-11,AS,0,3,3,0
2020-04-12,AS,0,3,3,0
2020-04-13,AS,0,3,3,0
2020-04-14,AS,0,3,3,0
2020-04-15,AS,0,3,3,0
2020-04-16,AS,0,3,3,0
2020-04-17,AS,0,3,3,0
2020-04-18,AS,0,3,3,0
2020-04-19,AS,0,3,3,0
2020-04-20,AS,0,3,3,0
2020-04-21,AS,0,3,3,0
2020-04-22,AS,0,3,3,0
2020-04-23,AS,0,3,3,0
2020-04-24,AS,0,3,3,0
2020-04-25,AS,0,3,3,0
2020-04-26,AS,0,3,3,0
2020-04-27,AS,0,3,3,0
2020-04-28,AS,0,3,3,0
2020-04-29,AS,0,3,3,0
2020-04-30,AS,0,3,3,0
2020-05-01,AS,0,57,57,0
2020-05-02,AS,0,57,57,0
2020-05-03,AS,0,57,57,0
2020-05-04,AS,0,83,83,0
2020-05-05,AS,0,83,83,0
2020-05-06,AS,0,83,83,0
2020-05-07,AS,0,83,83,0
2020-05-08,AS,0,83,83,0
2020-05-09,AS,0,83,83,0
2020-05-10,AS,0,83,83,0
2020-05-11,AS,0,105,105,0
2020-05-12,AS,0,105,105,0
2020-05-13,AS,0,105,105,0
2020-05-14,AS,0,105,105,0
2020-05-15,AS,0,105,105,0
2020-05-16,AS,0,105,105,0
2020-05-17,AS,0,105,105,0
2020-05-18,AS,0,105,105,0
2020-05-19,AS,0,124,124,0
2020-05-20,AS,0,124,124,0
2020-05-21,AS,0,124,124,0
2020-05-22,AS,0,124,124,0
2020-05-23,AS,0,124,124,0
2020-05-24,AS,0,124,124,0
2020-05-25,AS,0,124,124,0
2020-05-26,AS,0,124,124,0
2020-05-27,AS,0,174,174,0
2020-05-28,AS,0,174,174,0
2020-05-29,AS,0,174,174,0
2020-05-30,AS,0,174,174,0
2020-05-31,AS,0,174,174,0
2020-06-01,AS,0,174,174,0
2020-06-02,AS,0,174,174,0
2020-06-03,AS,0,174,174,0
2020-06-04,AS,0,174,174,0
2020-06-05,AS,0,174,174,0
2020-06-06,AS,0,174,174,0
2020-06-07,AS,0,174,174,0
2020-06-08,AS,0,174,174,0
2020-06-09,AS,0,174,174,0
2020-06-10,AS,0,174,174,0
2020-06-11,AS,0,174,174,0
2020-06-12,AS,0,174,174,0
2020-06-13,AS,0,174,174,0
2020-06-14,AS,0,174,174,0
2020-06-15,AS,0,174,174,0
2020-06-16,AS,0,174,174,0
2020-06-17,AS,0,174,174,0
2020-06-18,AS,0,174,174,0
2020-06-19,AS,0,174,174,0
2020-06-20,AS,0,174,174,0
2020-06-21,AS,0,174,174,0
2020-06-22,AS,0,174,174,0
2020-06-23,AS,0,174,174,0
2020-06-24,AS,0,174,174,0
2020-06-25,AS,0,696,696,0
2020-06-26,AS,0,696,696,0
2020-06-27,AS,0,696,696,0
2020-06-28,AS,0,696,696,0
2020-06-29,AS,0,696,696,0
2020-06-30,AS,0,696,696,0
2020-07-01,AS,0,696,696,0
2020-07-02,AS,0,696,696,0
2020-07-03,AS,0,696,696,0
2020-07-04,AS,0,696,696,0
2020-07-05,AS,0,696,696,0
2020-07-06,AS,0,696,696,0
2020-07-07,AS,0,696,696,0
2020-07-08,AS,0,816,816,0
2020-07-09,AS,0,816,816,0
2020-07-10,AS,0,816,816,0
2020-07-11,AS,0,816,816,0
2020-07-12,AS,0,816,816,0
2020-07-13,AS,0,816,816,0
2020-07-14,AS,0,816,816,0
2020-07-15,AS,0,816,816,0
2020-07-16,AS,0,1037,1037,0
2020-07-17,AS,0,1037,1037,0
2020-07-18,AS,0,1037,1037,0
2020-07-19,AS,0,1037,1037,0
2020-07-20,AS,0,1037,1037,0
2020-07-21,AS,0,1037,1037,0
2020-07-22,AS,0,1037,1037,0
2020-07-23,AS,0,1037,1037,0
2020-07-24,AS,0,1037,1037,0
2020-07-25,AS,0,1037,1037,0
2020-03-04,AZ,2,27,29,0
2020-03-05,AZ,2,28,30,0
2020-03-06,AZ,3,33,36,0
2020-03-07,AZ,5,44,49,0
2020-03-08,AZ,5,44,49,0
2020-03-09,AZ,5,44,49,0
2020-03-10,AZ,6,51,57,0
2020-03-11,AZ,9,59,68,0
2020-03-12,AZ,9,82,91,0
2020-03-13,AZ,9,94,103,0
2020-03-14,AZ,12,121,133,0
2020-03-15,AZ,12,121,133,0
2020-03-16,AZ,18,125,143,0
2020-03-17,AZ,20,142,162,0
2020-03-18,AZ,28,148,176,0
2020-03-19,AZ,44,175,219,0
2020-03-20,AZ,65,211,276,0
2020-03-21,AZ,104,240,344,1
2020-03-22,AZ,152,282,434,2
2020-03-23,AZ,265,309,574,2
2020-03-24,AZ,357,313,670,5
2020-03-25,AZ,450,323,773,6
2020-03-26,AZ,577,347,924,8
2020-03-27,AZ,736,7455,8191,13
2020-03-28,AZ,873,7455,8328,15
2020-03-29,AZ,919,12953,13872,17
2020-03-30,AZ,1157,15602,16759,20
2020-03-31,AZ,1289,18082,19371,24
2020-04-01,AZ,1413,19645,21058,29
2020-04-02,AZ,1598,21111,22709,32
2020-04-03,AZ,1769,22904,24673,41
2020-04-04,AZ,2019,25141,27160,52
2020-04-05,AZ,2269,25141,27410,64
2020-04-06,AZ,2456,30078,32534,65
2020-04-07,AZ,2575,30800,33375,73
2020-04-08,AZ,2726,31838,34564,80
2020-04-09,AZ,3018,34160,37178,89
2020-04-10,AZ,3112,34622,37734,97
2020-04-11,AZ,3393,37137,40530,108
2020-04-12,AZ,3539,38570,42109,115
2020-04-13,AZ,3702,39645,43347,122
2020-04-14,AZ,3806,40290,44096,131
2020-04-15,AZ,3962,41348,45310,142
2020-04-16,AZ,4234,43164,47398,150
2020-04-17,AZ,4507,44723,49230,169
2020-04-18,AZ,4719,46326,51045,177
2020-04-19,AZ,4929,48061,52990,184
2020-04-20,AZ,5064,49436,54500,187
2020-04-21,AZ,5251,49901,55152,208
2020-04-22,AZ,5459,51142,56601,229
2020-04-23,AZ,5769,52928,58697,249
2020-04-24,AZ,6045,54669,60714,266
2020-04-25,AZ,6280,56228,62508,266
2020-04-26,AZ,6526,58285,64811,275
2020-04-27,AZ,6716,59827,66543,275
2020-04-28,AZ,6948,60490,67438,293
2020-04-29,AZ,7202,61611,68813,304
2020-04-30,AZ,7648,64138,71786,320
2020-05-01,AZ,7962,66917,74879,330
2020-05-02,AZ,8364,69633,77997,348
2020-05-03,AZ,8640,72479,81119,362
2020-05-04,AZ,8919,76334,85253,362
2020-05-05,AZ,9305,78955,88260,395
2020-05-06,AZ,9707,82030,91737,426
2020-05-07,AZ,9945,86489,96434,450
2020-05-08,AZ,10526,90599,101125,517
2020-05-09,AZ,10960,94850,105810,532
2020-05-10,AZ,11119,99258,110377,536
2020-05-11,AZ,11380,105084,116464,542
2020-05-12,AZ,11736,111106,122842,562
2020-05-13,AZ,12176,115574,127750,594
2020-05-14,AZ,12674,121664,134338,624
2020-05-15,AZ,13169,128832,142001,651
2020-05-16,AZ,13631,133157,146788,679
2020-05-17,AZ,13937,137824,151761,680
2020-05-18,AZ,14170,142303,156473,686
2020-05-19,AZ,14566,147005,161571,704
2020-05-20,AZ,14897,150538,165435,747
2020-05-21,AZ,15315,156312,171627,763
2020-05-22,AZ,15608,160395,176003,775
2020-05-23,AZ,16039,164400,180439,799
2020-05-24,AZ,16339,167302,183641,800
2020-05-25,AZ,16561,171221,187782,806
2020-05-26,AZ,16783,173948,190731,807
2020-05-27,AZ,17262,179004,196266,831
2020-05-28,AZ,17763,185151,202914,857
2020-05-29,AZ,18465,191348,209813,885
2020-05-30,AZ,19255,197792,217047,903
2020-05-31,AZ,19936,205270,225206,906
2020-06-01,AZ,20123,207947,228070,917
2020-06-02,AZ,21250,216583,237833,941
2020-06-03,AZ,22233,222292,244525,981
2020-06-04,AZ,22753,227002,249755,996
2020-06-05,AZ,24332,239533,263865,1012
2020-06-06,AZ,25451,246195,271646,1042
2020-06-07,AZ,26889,254732,281621,1044
2020-06-08,AZ,27678,260403,288081,1047
2020-06-09,AZ,28296,264917,293213,1070
2020-06-10,AZ,29852,269835,299687,1095
2020-06-11,AZ,31264,278318,309582,1127
2020-06-12,AZ,32918,289861,322779,1144
2020-06-13,AZ,34458,293939,328397,1183
2020-06-14,AZ,35691,302354,338045,1186
2020-06-15,AZ,36705,308552,345257,1194
2020-06-16,AZ,39097,315237,354334,1219
2020-06-17,AZ,40924,325269,366193,1239
2020-06-18,AZ,43443,336289,379732,1271
2020-06-19,AZ,46689,345527,392216,1312
2020-06-20,AZ,49798,355482,405280,1338
2020-06-21,AZ,52390,367354,419744,1339
2020-06-22,AZ,54586,375204,429790,1342
2020-06-23,AZ,58179,382339,440518,1384
2020-06-24,AZ,59974,389214,449188,1463
2020-06-25,AZ,63030,401166,464196,1490
2020-06-26,AZ,66548,413275,479823,1535
2020-06-27,AZ,70051,424696,494747,1579
2020-06-28,AZ,73908,435988,509896,1588
2020-06-29,AZ,74533,436890,511423,1588
2020-06-30,AZ,79215,453141,532356,1632
2020-07-01,AZ,84092,465504,549596,1720
2020-07-02,AZ,87425,473414,560839,1757
2020-07-03,AZ,91858,486523,578381,1788
2020-07-04,AZ,94553,494955,589508,1805
2020-07-05,AZ,98089,506273,604362,1809
2020-07-06,AZ,101441,516400,617841,1810
2020-07-07,AZ,105094,523703,628797,1927
2020-07-08,AZ,108614,532456,641070,1963
2020-07-09,AZ,112671,540390,653061,2038
2020-07-10,AZ,116892,552319,669211,2082
2020-07-11,AZ,119930,564060,683990,2151
2020-07-12,AZ,122467,573705,696172,2237
2020-07-13,AZ,123824,578602,702426,2245
2020-07-14,AZ,128097,593846,721943,2337
2020-07-15,AZ,131354,604608,735962,2434
2020-07-16,AZ,134613,614653,749266,2492
2020-07-17,AZ,138523,626445,764968,2583
2020-07-18,AZ,141265,630726,771991,2730
2020-07-19,AZ,143624,642355,785979,2761
2020-07-20,AZ,145183,648340,793523,2784
2020-07-21,AZ,148683,658983,807666,2918
2020-07-22,AZ,150609,663372,813981,2974
2020-07-23,AZ,152944,669769,822713,3063
2020-07-24,AZ,156301,680516,836817,3142
2020-07-25,AZ,160041,697568,857609,3286
2020-03-04,CA,53,462,515,0
2020-03-05,CA,53,462,515,0
2020-03-06,CA,60,462,522,0
2020-03-07,CA,69,462,531,0
2020-03-08,CA,88,462,550,0
2020-03-09,CA,114,690,804,0
2020-03-10,CA,133,690,823,0
2020-03-11,CA,157,916,1073,0
2020-03-12,CA,202,916,1118,4
2020-03-13,CA,202,916,1118,4
2020-03-14,CA,252,916,1168,5
2020-03-15,CA,293,916,1209,5
2020-03-16,CA,335,7981,8316,6
2020-03-17,CA,483,7981,8464,11
2020-03-18,CA,611,7981,8592,13
2020-03-19,CA,924,8787,9711,18
2020-03-20,CA,1063,10424,11487,20
2020-03-21,CA,1279,11249,12528,24
2020-03-22,CA,1536,11304,12840,27
2020-03-23,CA,1733,12567,14300,27
2020-03-24,CA,2102,13452,15554,40
2020-03-25,CA,2355,15921,18276,53
2020-03-26,CA,3006,17380,20386,65
2020-03-27,CA,3879,17380,21259,78
2020-03-28,CA,4643,20549,25192,101
2020-03-29,CA,5708,20549,26257,123
2020-03-30,CA,6447,20549,26996,133
2020-03-31,CA,7482,21772,29254,153
2020-04-01,CA,8155,21772,29927,171
2020-04-02,CA,9191,23809,33000,203
2020-04-03,CA,10701,24599,35300,237
2020-04-04,CA,12026,101674,113700,276
2020-04-05,CA,13438,103095,116533,319
2020-04-06,CA,14336,103095,117431,343
2020-04-07,CA,15865,115364,131229,374
2020-04-08,CA,16957,127307,144264,442
2020-04-09,CA,18309,145191,163500,492
2020-04-10,CA,19472,145391,164863,541
2020-04-11,CA,20615,152604,173219,609
2020-04-12,CA,21794,168534,190328,651
2020-04-13,CA,22348,168534,190882,687
2020-04-14,CA,23338,178870,202208,758
2020-04-15,CA,24424,192062,216486,821
2020-04-16,CA,26182,220218,246400,890
2020-04-17,CA,27528,224086,251614,985
2020-04-18,CA,28963,230703,259666,1072
2020-04-19,CA,30333,250567,280900,1166
2020-04-20,CA,30978,259522,290500,1208
2020-04-21,CA,33261,266839,300100,1268
2020-04-22,CA,35396,429931,465327,1354
2020-04-23,CA,37369,444728,482097,1469
2020-04-24,CA,39254,454919,494173,1562
2020-04-25,CA,41137,464898,506035,1651
2020-04-26,CA,42164,483920,526084,1710
2020-04-27,CA,43464,509945,553409,1755
2020-04-28,CA,45031,532577,577608,1809
2020-04-29,CA,46500,556639,603139,1887
2020-04-30,CA,48917,576420,625337,1982
2020-05-01,CA,50442,604543,654985,2073
2020-05-02,CA,52197,634606,686803,2171
2020-05-03,CA,53616,662135,715751,2215
2020-05-04,CA,54937,692937,747874,2254
2020-05-05,CA,56212,723690,779902,2317
2020-05-06,CA,58815,750221,809036,2412
2020-05-07,CA,60614,782260,842874,2504
2020-05-08,CA,62512,812760,875272,2585
2020-05-09,CA,64561,848009,912570,2678
2020-05-10,CA,66680,888984,955664,2745
2020-05-11,CA,67939,923958,991897,2770
2020-05-12,CA,69382,963988,1033370,2847
2020-05-13,CA,71141,994451,1065592,2934
2020-05-14,CA,73164,1031487,1104651,3032
2020-05-15,CA,74936,1058970,1133906,3108
2020-05-16,CA,76793,1102333,1179126,3204
2020-05-17,CA,78839,1156404,1235243,3261
2020-05-18,CA,80430,1212242,1292672,3302
2020-05-19,CA,81795,1257521,1339316,3334
2020-05-20,CA,84057,1296063,1380120,3436
2020-05-21,CA,86197,1334930,1421127,3542
2020-05-22,CA,88444,1378329,1466773,3630
2020-05-23,CA,90631,1424675,1515306,3708
2020-05-24,CA,92710,1490035,1582745,3774
2020-05-25,CA,94558,1549544,1644102,3795
2020-05-26,CA,96733,1599663,1696396,3814
2020-05-27,CA,98980,1637914,1736894,3884
2020-05-28,CA,101697,1688862,1790559,3973
2020-05-29,CA,103886,1731592,1835478,4068
2020-05-30,CA,106878,1781717,1888595,4156
2020-05-31,CA,110583,1834265,1944848,4213
2020-06-01,CA,113006,1899577,2012583,4251
2020-06-02,CA,115310,1956281,2071591,4286
2020-06-03,CA,117687,2013607,2131294,4361
2020-06-04,CA,119807,2062864,2182671,4422
2020-06-05,CA,122901,2115562,2238463,4485
2020-06-06,CA,126016,2182284,2308300,4559
2020-06-07,CA,128812,2233406,2362218,4626
2020-06-08,CA,131319,2299871,2431190,4653
2020-06-09,CA,133489,2352756,2486245,4697
2020-06-10,CA,136191,2404607,2540798,4776
2020-06-11,CA,139281,2458366,2597647,4881
2020-06-12,CA,141983,2520275,2662258,4943
2020-06-13,CA,145643,2578750,2724393,4989
2020-06-14,CA,148855,2653141,2801996,5063
2020-06-15,CA,151452,2716730,2868182,5089
2020-06-16,CA,153560,2784195,2937755,5121
2020-06-17,CA,157015,2840973,2997988,5208
2020-06-18,CA,161099,2913431,3074530,5290
2020-06-19,CA,165416,2990286,3155702,5360
2020-06-20,CA,169309,3065103,3234412,5424
2020-06-21,CA,173824,3145432,3319256,5495
2020-06-22,CA,178054,3233632,3411686,5515
2020-06-23,CA,183073,3313856,3496929,5580
2020-06-24,CA,190222,3402677,3592899,5632
2020-06-25,CA,195571,3498774,3694345,5733
2020-06-26,CA,200461,3570853,3771314,5812
2020-06-27,CA,206433,3655877,3862310,5872
2020-06-28,CA,211243,3744709,3955952,5905
2020-06-29,CA,219252,3842440,4061692,5936
2020-06-30,CA,228732,3938407,4167139,5980
2020-07-01,CA,236139,4018037,4254176,6090
2020-07-02,CA,242547,4096171,4338718,6163
2020-07-03,CA,248235,4199941,4448176,6263
2020-07-04,CA,257388,4295643,4553031,6313
2020-07-05,CA,265985,4414153,4680138,6331
2020-07-06,CA,271684,4521669,4793353,6337
2020-07-07,CA,277774,4618596,4896370,6448
2020-07-08,CA,289468,4706707,4996175,6562
2020-07-09,CA,296499,4781935,5078434,6711
2020-07-10,CA,304297,4871440,5175737,6851
2020-07-11,CA,312344,4963351,5275695,6945
2020-07-12,CA,320804,5085795,5406599,7017
2020-07-13,CA,329162,5215203,5544365,7040
2020-07-14,CA,336508,5338447,5674955,7087
2020-07-15,CA,347634,5445642,5793276,7227
2020-07-16,CA,356178,5559330,5915508,7345
2020-07-17,CA,366164,5677935,6044099,7475
2020-07-18,CA,375363,5791855,6167218,7595
2020-07-19,CA,384692,5902160,6286852,7685
2020-07-20,CA,391538,6022783,6414321,7694
2020-07-21,CA,400769,6136163,6536932,7755
2020-07-22,CA,413576,6250843,6664419,7870
2020-07-23,CA,425616,6352688,6778304,8027
2020-07-24,CA,435334,6480542,6915876,8186
2020-07-25,CA,445400,6601955,7047355,8337
2020-03-05,CO,0,19,19,0
2020-03-06,CO,2,46,48,0
2020-03-07,CO,8,55,63,0
2020-03-08,CO,8,104,112,0
2020-03-09,CO,9,133,142,0
2020-03-10,CO,12,142,154,0
2020-03-11,CO,28,251,279,0
2020-03-12,CO,45,298,343,0
2020-03-13,CO,72,524,596,0
2020-03-14,CO,101,610,711,1
2020-03-15,CO,131,627,758,1
2020-03-16,CO,131,627,758,1
2020-03-17,CO,160,1056,1216,1
2020-03-18,CO,183,1617,1800,2
2020-03-19,CO,216,2112,2328,2
2020-03-20,CO,277,2675,2952,3
2020-03-21,CO,363,3317,3680,4
2020-03-22,CO,475,4075,4550,5
2020-03-23,CO,591,4845,5436,6
2020-03-24,CO,720,5504,6224,7
2020-03-25,CO,912,6789,7701,11
2020-03-26,CO,1086,6978,8064,19
2020-03-27,CO,1430,8692,10122,24
2020-03-28,CO,1734,9942,11676,31
2020-03-29,CO,2061,11215,13276,44
2020-03-30,CO,2627,12737,15364,51
2020-03-31,CO,2627,12737,15364,51
2020-04-01,CO,2966,13883,16849,69
2020-04-02,CO,3342,15303,18645,80
2020-04-03,CO,3728,16683,20411,97
2020-04-04,CO,4173,17898,22071,111
2020-04-05,CO,4565,19335,23900,126
2020-04-06,CO,4950,20823,25773,140
2020-04-07,CO,5172,21703,26875,150
2020-04-08,CO,5429,22665,28094,179
2020-04-09,CO,5655,23544,29199,193
2020-04-10,CO,6510,26143,32653,250
2020-04-11,CO,6510,26143,32653,250
2020-04-12,CO,6893,27980,34873,274
2020-04-13,CO,7684,29850,37534,304
2020-04-14,CO,7691,31051,38742,308
2020-04-15,CO,7941,31639,39580,329
2020-04-16,CO,8280,32253,40533,357
2020-04-17,CO,8675,33155,41830,374
2020-04-18,CO,9047,34260,43307,391
2020-04-19,CO,9433,35173,44606,411
2020-04-20,CO,9730,36465,46195,422
2020-04-21,CO,10106,37360,47466,449
2020-04-22,CO,10447,38257,48704,486
2020-04-23,CO,10878,39767,50645,508
2020-04-24,CO,11262,41062,52324,552
2020-04-25,CO,12256,44533,56789,674
2020-04-26,CO,12968,46823,59791,672
2020-04-27,CO,13441,49833,63274,680
2020-04-28,CO,13879,52462,66341,706
2020-04-29,CO,14735,54714,69449,760
2020-04-30,CO,14758,56301,71059,766
2020-05-01,CO,15284,57106,72390,777
2020-05-02,CO,15768,61181,76949,820
2020-05-03,CO,16225,63681,79906,832
2020-05-04,CO,16635,66455,83090,842
2020-05-05,CO,16907,68097,85004,851
2020-05-06,CO,17364,68612,85976,903
2020-05-07,CO,17830,73517,91347,921
2020-05-08,CO,18801,75735,94536,961
2020-05-09,CO,18827,77945,96772,960
2020-05-10,CO,19703,84374,104077,967
2020-05-11,CO,19899,88891,108790,981
2020-05-12,CO,19879,88778,108657,987
2020-05-13,CO,20157,91093,111250,1009
2020-05-14,CO,20475,94044,114519,1062
2020-05-15,CO,20838,97192,118030,1091
2020-05-16,CO,21232,100608,121840,878
2020-05-17,CO,21633,103915,125548,878
2020-05-18,CO,21938,106557,128495,878
2020-05-19,CO,22202,109131,131333,921
2020-05-20,CO,22482,109355,131837,968
2020-05-21,CO,22797,112814,135611,1001
2020-05-22,CO,23191,119034,142225,1062
2020-05-23,CO,23487,121465,144952,1088
2020-05-24,CO,23964,126087,150051,1088
2020-05-25,CO,24174,126134,150308,1088
2020-05-26,CO,24269,131742,156011,1088
2020-05-27,CO,24565,134855,159420,1114
2020-05-28,CO,24767,138356,163123,1135
2020-05-29,CO,25121,143838,168959,1168
2020-05-30,CO,25613,150128,175741,1181
2020-05-31,CO,26098,154529,180627,1181
2020-06-01,CO,26378,159998,186376,1181
2020-06-02,CO,26577,163960,190537,1185
2020-06-03,CO,26788,167389,194177,1228
2020-06-04,CO,27060,170140,197200,1254
2020-06-05,CO,27360,176064,203424,1255
2020-06-06,CO,27615,180662,208277,1274
2020-06-07,CO,27848,185166,213014,1274
2020-06-08,CO,28001,189483,217484,1274
2020-06-09,CO,28183,193704,221887,1292
2020-06-10,CO,28347,197747,226094,1312
2020-06-11,CO,28499,201846,230345,1328
2020-06-12,CO,28647,205723,234370,1339
2020-06-13,CO,28822,207639,236461,1348
2020-06-14,CO,29017,215626,244643,1348
2020-06-15,CO,29130,219955,249085,1348
2020-06-16,CO,29299,223857,253156,1373
2020-06-17,CO,29442,227225,256667,1373
2020-06-18,CO,29673,232543,262216,1402
2020-06-19,CO,29901,234545,264446,1417
2020-06-20,CO,30187,242882,273069,1429
2020-06-21,CO,30349,248037,278386,1429
2020-06-22,CO,30539,252233,282772,1429
2020-06-23,CO,30705,257171,287876,1438
2020-06-24,CO,30893,259941,290834,1455
2020-06-25,CO,31155,264910,296065,1457
2020-06-26,CO,31479,271098,302577,1475
2020-06-27,CO,31796,275787,307583,1482
2020-06-28,CO,32022,281689,313711,1482
2020-06-29,CO,32307,287258,319565,1482
2020-06-30,CO,32511,291346,323857,1508
2020-07-01,CO,32715,294788,327503,1520
2020-07-02,CO,33029,300226,333255,1520
2020-07-03,CO,33352,306938,340290,1521
2020-07-04,CO,33619,312135,345754,1521
2020-07-05,CO,33866,316851,350717,1521
2020-07-06,CO,34065,321590,355655,1521
2020-07-07,CO,34257,326383,360640,1542
2020-07-08,CO,34664,330409,365073,1542
2020-07-09,CO,35116,335586,370702,1544
2020-07-10,CO,35525,341615,377140,1581
2020-07-11,CO,36191,349670,385861,1586
2020-07-12,CO,36591,355512,392103,1586
2020-07-13,CO,36913,362452,399365,1586
2020-07-14,CO,37242,367713,404955,1589
2020-07-15,CO,37686,372304,409990,1594
2020-07-16,CO,38155,378061,416216,1601
2020-07-17,CO,38726,385623,424349,1615
2020-07-18,CO,39344,391439,430783,1615
2020-07-19,CO,39788,396150,435938,1615
2020-07-20,CO,40142,402027,442169,1615
2020-07-21,CO,40566,410733,451299,1615
2020-07-22,CO,41059,416343,457402,1643
2020-07-23,CO,41698,423713,465411,1643
2020-07-24,CO,42314,428563,470877,1645
2020-07-25,CO,42980,436764,479744,1661
2020-03-07,CT,0,0,0,0
2020-03-08,CT,1,29,30,0
2020-03-09,CT,1,46,47,0
2020-03-10,CT,2,54,56,0
2020-03-11,CT,3,71,74,0
2020-03-12,CT,6,89,95,0
2020-03-13,CT,6,99,105,0
2020-03-14,CT,11,125,136,0
2020-03-15,CT,20,125,145,0
2020-03-16,CT,26,125,151,0
2020-03-17,CT,41,125,166,0
2020-03-18,CT,68,125,193,0
2020-03-19,CT,96,604,700,1
2020-03-20,CT,194,604,798,3
2020-03-21,CT,194,2106,2300,4
2020-03-22,CT,223,2877,3100,5
2020-03-23,CT,415,4085,4500,10
2020-03-24,CT,618,4682,5300,12
2020-03-25,CT,875,5023,5898,19
2020-03-26,CT,1012,5625,6637,21
2020-03-27,CT,1291,7109,8400,27
2020-03-28,CT,1291,7109,8400,27
2020-03-29,CT,1993,9907,11900,34
2020-03-30,CT,2571,12029,14600,36
2020-03-31,CT,3128,13029,16157,69
2020-04-01,CT,3557,13043,16600,85
2020-04-02,CT,3824,14476,18300,112
2020-04-03,CT,4914,15101,20015,131
2020-04-04,CT,5276,16753,22029,165
2020-04-05,CT,5675,17595,23270,189
2020-04-06,CT,6906,19780,26686,206
2020-04-07,CT,7781,21255,29036,277
2020-04-08,CT,7781,21255,29036,277
2020-04-09,CT,9784,23718,33502,380
2020-04-10,CT,10538,25750,36288,448
2020-04-11,CT,11510,28321,39831,494
2020-04-12,CT,12035,29185,41220,554
2020-04-13,CT,13381,30928,44309,602
2020-04-14,CT,13989,31852,45841,671
2020-04-15,CT,14755,35388,50143,868
2020-04-16,CT,15884,37238,53122,971
2020-04-17,CT,16809,38653,55462,1036
2020-04-18,CT,16809,38653,55462,1036
2020-04-19,CT,17550,40663,58213,1086
2020-04-20,CT,19815,42991,62806,1331
2020-04-21,CT,20360,43832,64192,1423
2020-04-22,CT,22469,47449,69918,1544
2020-04-23,CT,23100,48397,71497,1639
2020-04-24,CT,23921,50117,74038,1764
2020-04-25,CT,24582,53020,77602,1862
2020-04-26,CT,25269,54542,79811,1924
2020-04-27,CT,25269,54542,79811,1998
2020-04-28,CT,26312,66433,92745,2089
2020-04-29,CT,26767,68051,94818,2168
2020-04-30,CT,27700,69433,97133,2257
2020-05-01,CT,28764,71493,100257,2339
2020-05-02,CT,28764,71493,100257,2339
2020-05-03,CT,29287,73206,102493,2436
2020-05-04,CT,29287,73206,102493,2495
2020-05-05,CT,30621,78022,108643,2633
2020-05-06,CT,30995,80452,111447,2718
2020-05-07,CT,31784,84390,116174,2797
2020-05-08,CT,32411,88130,120541,2874
2020-05-09,CT,32984,90585,123569,2932
2020-05-10,CT,33554,96638,130192,2967
2020-05-11,CT,33765,98743,132508,3008
2020-05-12,CT,34333,104091,138424,3041
2020-05-13,CT,34855,108088,142943,3125
2020-05-14,CT,35464,114098,149562,3219
2020-05-15,CT,36085,119823,155908,3285
2020-05-16,CT,36703,128052,164755,3339
2020-05-17,CT,37419,133188,170607,3408
2020-05-18,CT,38116,139563,177679,3449
2020-05-19,CT,38430,147090,185520,3472
2020-05-20,CT,39017,151701,190718,3529
2020-05-21,CT,39208,157239,196447,3582
2020-05-22,CT,39640,162688,202328,3637
2020-05-23,CT,40022,168345,208367,3675
2020-05-24,CT,40468,173668,214136,3693
2020-05-25,CT,40873,180853,221726,3742
2020-05-26,CT,41303,184059,225362,3769
2020-05-27,CT,41288,187581,228869,3803
2020-05-28,CT,41559,193966,235525,3826
2020-05-29,CT,41762,199631,241393,3868
2020-05-30,CT,42022,204913,246935,3912
2020-05-31,CT,42201,207845,250046,3944
2020-06-01,CT,42740,218650,261390,3964
2020-06-02,CT,42979,227631,270610,3972
2020-06-03,CT,43091,233345,276436,3989
2020-06-04,CT,43239,238286,281525,4007
2020-06-05,CT,43460,243927,287387,4038
2020-06-06,CT,43818,259611,303429,4055
2020-06-07,CT,43968,265055,309023,4071
2020-06-08,CT,44092,269603,313695,4084
2020-06-09,CT,44179,273843,318022,4097
2020-06-10,CT,44347,278657,323004,4120
2020-06-11,CT,44461,286610,331071,4146
2020-06-12,CT,44689,300443,345132,4159
2020-06-13,CT,44994,305173,350167,4186
2020-06-14,CT,45088,312263,357351,4201
2020-06-15,CT,45235,317038,362273,4204
2020-06-16,CT,45349,323359,368708,4210
2020-06-17,CT,45429,327850,373279,4219
2020-06-18,CT,45440,334853,380293,4226
2020-06-19,CT,45557,346531,392088,4238
2020-06-20,CT,45715,350172,395887,4251
2020-06-21,CT,45755,352175,397930,4260
2020-06-22,CT,45782,358499,404281,4263
2020-06-23,CT,45899,356898,402797,4277
2020-06-24,CT,45913,363357,409270,4287
2020-06-25,CT,45994,371126,417120,4298
2020-06-26,CT,46059,383765,429824,4307
2020-06-27,CT,46206,392824,439030,4311
2020-06-28,CT,46303,399057,445360,4316
2020-06-29,CT,46362,420460,466822,4320
2020-06-30,CT,46514,431844,478358,4322
2020-07-01,CT,46572,443237,489809,4324
2020-07-02,CT,46646,453468,500114,4326
2020-07-03,CT,46717,453369,500086,4335
2020-07-04,CT,46717,453309,500026,4335
2020-07-05,CT,46717,477851,524568,4335
2020-07-06,CT,46976,483537,530513,4338
2020-07-07,CT,47033,490793,537826,4338
2020-07-08,CT,47108,498895,546003,4343
2020-07-09,CT,47209,511233,558442,4348
2020-07-10,CT,47287,511174,558461,4348
2020-07-11,CT,47287,511101,558388,4348
2020-07-12,CT,47287,542107,589394,4348
2020-07-13,CT,47510,544470,591980,4371
2020-07-14,CT,47530,556593,604123,4372
2020-07-15,CT,47636,568022,615658,4380
2020-07-16,CT,47750,582333,630083,4389
2020-07-17,CT,47893,582215,630108,4396
2020-07-18,CT,47893,582076,629969,4396
2020-07-19,CT,47893,609238,657131,4396
2020-07-20,CT,48055,614741,662796,4406
2020-07-21,CT,48096,614741,662837,4406
2020-07-22,CT,48223,626183,674406,4406
2020-07-23,CT,48232,639656,687888,4410
2020-07-24,CT,48776,664296,713072,4413
2020-07-25,CT,48776,664296,713072,4413
2020-03-05,DC,0,6,6,0
2020-03-06,DC,0,8,8,0
2020-03-07,DC,0,8,8,0
2020-03-08,DC,1,10,11,0
2020-03-09,DC,1,14,15,0
2020-03-10,DC,5,17,22,0
2020-03-11,DC,5,20,25,0
2020-03-12,DC,10,20,30,0
2020-03-13,DC,10,20,30,0
2020-03-14,DC,10,49,59,0
2020-03-15,DC,16,79,95,0
2020-03-16,DC,17,96,113,0
2020-03-17,DC,22,104,126,0
2020-03-18,DC,31,138,169,0
2020-03-19,DC,39,153,192,0
2020-03-20,DC,71,501,572,1
2020-03-21,DC,77,506,583,1
2020-03-22,DC,98,957,1055,1
2020-03-23,DC,116,1113,1229,2
2020-03-24,DC,137,1195,1332,2
2020-03-25,DC,183,1423,1606,2
2020-03-26,DC,231,1626,1857,3
2020-03-27,DC,267,1897,2164,3
2020-03-28,DC,304,2211,2515,4
2020-03-29,DC,342,2469,2811,5
2020-03-30,DC,401,2682,3083,9
2020-03-31,DC,495,3262,3757,9
2020-04-01,DC,586,3262,3848,11
2020-04-02,DC,653,4417,5070,12
2020-04-03,DC,757,4827,5584,15
2020-04-04,DC,902,5536,6438,21
2020-04-05,DC,998,5836,6834,22
2020-04-06,DC,1097,6356,7453,24
2020-04-07,DC,1211,6612,7823,22
2020-04-08,DC,1440,6843,8283,27
2020-04-09,DC,1523,7201,8724,32
2020-04-10,DC,1660,7695,9355,38
2020-04-11,DC,1778,8261,10039,47
2020-04-12,DC,1875,8765,10640,50
2020-04-13,DC,1955,8979,10934,53
2020-04-14,DC,2058,9226,11284,67
2020-04-15,DC,2197,9328,11525,72
2020-04-16,DC,2350,9800,12150,81
2020-04-17,DC,2476,10167,12643,86
2020-04-18,DC,2666,10602,13268,91
2020-04-19,DC,2793,10906,13699,96
2020-04-20,DC,2927,11186,14113,105
2020-04-21,DC,3098,11841,14939,112
2020-04-22,DC,3206,12296,15502,127
2020-04-23,DC,3361,12569,15930,139
2020-04-24,DC,3528,13005,16533,153
2020-04-25,DC,3699,13603,17302,165
2020-04-26,DC,3841,14227,18068,178
2020-04-27,DC,3892,14524,18416,185
2020-04-28,DC,3994,14891,18885,190
2020-04-29,DC,4106,15123,19229,205
2020-04-30,DC,4323,15756,20079,224
2020-05-01,DC,4658,16477,21135,231
2020-05-02,DC,4797,17207,22004,240
2020-05-03,DC,5016,18086,23102,251
2020-05-04,DC,5170,18625,23795,258
2020-05-05,DC,5322,19007,24329,264
2020-05-06,DC,5461,19523,24984,277
2020-05-07,DC,5654,20202,25856,285
2020-05-08,DC,5899,21216,27115,304
2020-05-09,DC,6102,22081,28183,311
2020-05-10,DC,6272,23298,29570,323
2020-05-11,DC,6389,23872,30261,328
2020-05-12,DC,6485,24565,31050,336
2020-05-13,DC,6584,25074,31658,350
2020-05-14,DC,6736,26263,32999,358
2020-05-15,DC,6871,27468,34339,368
2020-05-16,DC,7042,28490,35532,375
2020-05-17,DC,7123,29403,36526,383
2020-05-18,DC,7270,30555,37825,392
2020-05-19,DC,7434,31940,39374,400
2020-05-20,DC,7551,32868,40419,407
2020-05-21,DC,7788,33968,41756,412
2020-05-22,DC,7893,35100,42993,418
2020-05-23,DC,7966,44025,51991,427
2020-05-24,DC,7966,44025,51991,427
2020-05-25,DC,8225,32578,40803,440
2020-05-26,DC,8334,33721,42055,440
2020-05-27,DC,8406,34291,42697,445
2020-05-28,DC,8492,35022,43514,453
2020-05-29,DC,8538,35320,43858,460
2020-05-30,DC,8717,36912,45629,462
2020-05-31,DC,8801,37682,46483,466
2020-06-01,DC,8857,38406,47263,468
2020-06-02,DC,8886,38815,47701,470
2020-06-03,DC,9016,40546,49562,473
2020-06-04,DC,9120,41976,51096,475
2020-06-05,DC,9199,42662,51861,475
2020-06-06,DC,9269,44409,53678,483
2020-06-07,DC,9332,45215,54547,489
2020-06-08,DC,9389,46377,55766,491
2020-06-09,DC,9474,47678,57152,495
2020-06-10,DC,9537,48655,58192,499
2020-06-11,DC,9589,49699,59288,502
2020-06-12,DC,9654,52299,61953,506
2020-06-13,DC,9709,53327,63036,511
2020-06-14,DC,9767,54763,64530,515
2020-06-15,DC,9799,56047,65846,515
2020-06-16,DC,9818,57308,67126,520
2020-06-17,DC,9847,60239,70086,523
2020-06-18,DC,9903,62296,72199,527
2020-06-19,DC,9952,63839,73791,530
2020-06-20,DC,9984,67969,77953,531
2020-06-21,DC,10020,69502,79522,533
2020-06-22,DC,10058,71946,82004,535
2020-06-23,DC,10094,73208,83302,537
2020-06-24,DC,10128,74045,84173,541
2020-06-25,DC,10159,76572,86731,543
2020-06-26,DC,10185,77938,88123,546
2020-06-27,DC,10216,79055,89271,548
2020-06-28,DC,10248,82884,93132,550
2020-06-29,DC,10292,85068,95360,551
2020-06-30,DC,10327,86968,97295,551
2020-07-01,DC,10365,89670,100035,553
2020-07-02,DC,10390,90673,101063,554
2020-07-03,DC,10435,92374,102809,555
2020-07-04,DC,10447,94107,104554,557
2020-07-05,DC,10482,95511,105993,559
2020-07-06,DC,10515,97135,107650,561
2020-07-07,DC,10569,99808,110377,561
2020-07-08,DC,10642,103647,114289,564
2020-07-09,DC,10679,105244,115923,568
2020-07-10,DC,10743,110141,120884,568
2020-07-11,DC,10801,113249,124050,568
2020-07-12,DC,10847,116036,126883,568
2020-07-13,DC,10906,119314,130220,568
2020-07-14,DC,10946,122970,133916,568
2020-07-15,DC,11026,126918,137944,571
2020-07-16,DC,11076,129166,140242,574
2020-07-17,DC,11115,130492,141607,577
2020-07-18,DC,11194,133761,144955,578
2020-07-19,DC,11261,136504,147765,578
2020-07-20,DC,11339,140401,151740,579
2020-07-21,DC,11427,144284,155711,580
2020-07-22,DC,11529,148043,159572,580
2020-07-23,DC,11571,150450,162021,581
2020-07-24,DC,11649,153611,165260,581
2020-07-25,DC,11717,157292,169009,581
2020-03-06,DE,0,10,10,0
2020-03-07,DE,0,10,10,0
2020-03-08,DE,0,10,10,0
2020-03-09,DE,0,15,15,0
2020-03-10,DE,0,17,17,0
2020-03-11,DE,1,17,18,0
2020-03-12,DE,4,23,27,0
2020-03-13,DE,4,30,34,0
2020-03-14,DE,6,36,42,0
2020-03-15,DE,6,36,42,0
2020-03-16,DE,8,36,44,0
2020-03-17,DE,16,36,52,0
2020-03-18,DE,25,36,61,0
2020-03-19,DE,30,36,66,0
2020-03-20,DE,38,36,74,0
2020-03-21,DE,45,36,81,0
2020-03-22,DE,56,36,92,0
2020-03-23,DE,68,36,104,0
2020-03-24,DE,91,36,127,1
2020-03-25,DE,115,36,151,2
2020-03-26,DE,130,36,166,3
2020-03-27,DE,163,36,199,5
2020-03-28,DE,214,36,250,9
2020-03-29,DE,232,36,268,10
2020-03-30,DE,264,2216,2480,11
2020-03-31,DE,319,3696,4015,12
2020-04-01,DE,368,4015,4383,13
2020-04-02,DE,393,4566,4959,16
2020-04-03,DE,450,4995,5445,17
2020-04-04,DE,593,5874,6467,17
2020-04-05,DE,673,6321,6994,19
2020-04-06,DE,673,6321,6994,24
2020-04-07,DE,928,7628,8556,28
2020-04-08,DE,928,7628,8556,32
2020-04-09,DE,1207,8683,9890,34
2020-04-10,DE,1326,10415,11741,36
2020-04-11,DE,1479,9624,11103,43
2020-04-12,DE,1479,9624,11103,48
2020-04-13,DE,1625,10195,11820,53
2020-04-14,DE,1761,10543,12304,60
2020-04-15,DE,2014,11088,13102,67
2020-04-16,DE,2075,11275,13350,70
2020-04-17,DE,2323,11694,14017,76
2020-04-18,DE,2323,11694,14017,86
2020-04-19,DE,2538,12256,14794,90
2020-04-20,DE,2745,12508,15253,99
2020-04-21,DE,2931,12935,15866,104
2020-04-22,DE,3200,13353,16553,117
2020-04-23,DE,3308,13604,16912,131
2020-04-24,DE,3442,13937,17379,147
2020-04-25,DE,3576,14122,17698,155
2020-04-26,DE,4034,15215,19249,168
2020-04-27,DE,4162,15454,19616,181
2020-04-28,DE,4575,16605,21180,192
2020-04-29,DE,4655,16883,21538,204
2020-04-30,DE,4734,17086,21820,210
2020-05-01,DE,4918,17667,22585,222
2020-05-02,DE,5038,18074,23112,235
2020-05-03,DE,5208,18529,23737,246
2020-05-04,DE,5288,18822,24110,255
2020-05-05,DE,5371,19309,24680,266
2020-05-06,DE,5778,20690,26468,269
2020-05-07,DE,5939,21387,27326,285
2020-05-08,DE,6111,22153,28264,297
2020-05-09,DE,6277,23019,29296,301
2020-05-10,DE,6447,24592,31039,312
2020-05-11,DE,6565,25363,31928,324
2020-05-12,DE,6741,26550,33291,334
2020-05-13,DE,6952,27801,34753,351
2020-05-14,DE,7223,29634,36857,362
2020-05-15,DE,7373,30905,38278,373
2020-05-16,DE,7547,32211,39758,383
2020-05-17,DE,7670,33195,40865,392
2020-05-18,DE,7869,34589,42458,399
2020-05-19,DE,8037,36095,44132,408
2020-05-20,DE,8194,37218,45412,414
2020-05-21,DE,8386,39156,47542,417
2020-05-22,DE,8529,40457,48986,420
2020-05-23,DE,8690,41844,50534,425
2020-05-24,DE,8809,43061,51870,431
2020-05-25,DE,8965,44931,53896,436
2020-05-26,DE,9066,45848,54914,444
2020-05-27,DE,9096,46325,55421,453
2020-05-28,DE,9171,47630,56801,459
2020-05-29,DE,9236,48297,57533,463
2020-05-30,DE,9422,49907,59329,466
2020-05-31,DE,9498,51173,60671,468
2020-06-01,DE,9605,52842,62447,471
2020-06-02,DE,9685,54377,64062,471
2020-06-03,DE,9712,55208,64920,475
2020-06-04,DE,9746,56163,65909,483
2020-06-05,DE,9773,56956,66729,485
2020-06-06,DE,9845,57790,67635,485
2020-06-07,DE,9942,59055,68997,488
2020-06-08,DE,9972,59975,69947,490
2020-06-09,DE,10020,60733,70753,492
2020-06-10,DE,10056,61689,71745,493
2020-06-11,DE,10106,63927,74033,494
2020-06-12,DE,10173,67521,77694,494
2020-06-13,DE,10229,69870,80099,495
2020-06-14,DE,10264,71523,81787,496
2020-06-15,DE,10340,74346,84686,498
2020-06-16,DE,10403,75671,86074,499
2020-06-17,DE,10444,76143,86587,502
2020-06-18,DE,10499,78185,88684,502
2020-06-19,DE,10611,79823,90434,504
2020-06-20,DE,10681,81735,92416,504
2020-06-21,DE,10775,84199,94974,504
2020-06-22,DE,10820,85903,96723,504
2020-06-23,DE,10847,86689,97536,504
2020-06-24,DE,10889,87312,98201,505
2020-06-25,DE,10980,90012,100992,507
2020-06-26,DE,11017,91083,102100,507
2020-06-27,DE,11091,93171,104262,507
2020-06-28,DE,11226,95120,106346,507
2020-06-29,DE,11376,98555,109931,507
2020-06-30,DE,11474,99407,110881,509
2020-07-01,DE,11510,99874,111384,509
2020-07-02,DE,11731,103187,114918,510
2020-07-03,DE,11923,106420,118343,512
2020-07-04,DE,11996,108697,120693,512
2020-07-05,DE,12128,111813,123941,512
2020-07-06,DE,12293,114886,127179,512
2020-07-07,DE,12414,116271,128685,514
2020-07-08,DE,12462,116572,129034,515
2020-07-09,DE,12531,117674,130205,517
2020-07-10,DE,12652,120056,132708,517
2020-07-11,DE,12743,121372,134115,517
2020-07-12,DE,12804,124605,137409,517
2020-07-13,DE,12879,126484,139363,517
2020-07-14,DE,12969,128631,141600,518
2020-07-15,DE,13050,130338,143388,521
2020-07-16,DE,13114,131756,144870,521
2020-07-17,DE,13337,135273,148610,521
2020-07-18,DE,13429,137328,150757,523
2020-07-19,DE,13519,139476,152995,523
2020-07-20,DE,13519,139476,152995,523
2020-07-21,DE,13746,144601,158347,525
2020-07-22,DE,13792,145641,159433,527
2020-07-23,DE,13924,148427,162351,529
2020-07-24,DE,14202,150124,164326,578
2020-07-25,DE,14175,152747,166922,579
2020-03-04,FL,2,24,26,0
2020-03-05,FL,9,31,40,0
2020-03-06,FL,9,55,64,0
2020-03-07,FL,14,100,114,0
2020-03-08,FL,17,118,135,0
2020-03-09,FL,18,140,158,0
2020-03-10,FL,19,222,241,0
2020-03-11,FL,28,301,329,2
2020-03-12,FL,32,301,333,2
2020-03-13,FL,50,478,528,2
2020-03-14,FL,77,478,555,3
2020-03-15,FL,116,678,794,4
2020-03-16,FL,141,684,825,4
2020-03-17,FL,186,940,1126,6
2020-03-18,FL,314,1225,1539,7
2020-03-19,FL,390,1533,1923,8
2020-03-20,FL,520,1870,2390,10
2020-03-21,FL,658,6579,7237,12
2020-03-22,FL,830,7990,8820,13
2020-03-23,FL,1171,11063,12234,14
2020-03-24,FL,1412,13127,14539,18
2020-03-25,FL,1682,15374,17056,22
2020-03-26,FL,2355,23741,26096,28
2020-03-27,FL,2765,28186,30951,34
2020-03-28,FL,3763,35366,39129,54
2020-03-29,FL,4246,39070,43316,56
2020-03-30,FL,5473,48225,53698,63
2020-03-31,FL,6338,54285,60623,77
2020-04-01,FL,6955,59529,66484,87
2020-04-02,FL,8010,69286,77296,128
2020-04-03,FL,9585,82137,91722,163
2020-04-04,FL,11111,90956,102067,191
2020-04-05,FL,12151,101253,113404,218
2020-04-06,FL,13324,109950,123274,236
2020-04-07,FL,14747,123415,138162,296
2020-04-08,FL,15455,127679,143134,309
2020-04-09,FL,16364,136185,152549,354
2020-04-10,FL,17531,145299,162830,390
2020-04-11,FL,18494,154439,172933,438
2020-04-12,FL,19355,163398,182753,465
2020-04-13,FL,20601,175606,196207,483
2020-04-14,FL,21367,181813,203180,537
2020-04-15,FL,22511,190998,213509,609
2020-04-16,FL,22897,196351,219248,646
2020-04-17,FL,24119,210718,234837,699
2020-04-18,FL,25269,221258,246527,754
2020-04-19,FL,25996,230083,256079,781
2020-04-20,FL,26660,239565,266225,806
2020-04-21,FL,27495,249564,277059,856
2020-04-22,FL,28309,260318,288627,910
2020-04-23,FL,28832,267876,296708,979
2020-04-24,FL,30174,286785,316959,1031
2020-04-25,FL,30839,302260,333099,1075
2020-04-26,FL,31528,313085,344613,1094
2020-04-27,FL,32138,324325,356463,1101
2020-04-28,FL,32846,334029,366875,1154
2020-04-29,FL,33193,340295,373488,1240
2020-04-30,FL,33690,348715,382405,1290
2020-05-01,FL,34728,367971,402699,1314
2020-05-02,FL,35463,380549,416012,1388
2020-05-03,FL,36078,392111,428189,1403
2020-05-04,FL,36897,407373,444270,1423
2020-05-05,FL,37439,428252,465691,1536
2020-05-06,FL,38002,442049,480051,1605
2020-05-07,FL,38828,454122,492950,1667
2020-05-08,FL,39199,474142,513341,1738
2020-05-09,FL,40001,487730,527731,1785
2020-05-10,FL,40596,498352,538948,1791
2020-05-11,FL,40982,520075,561057,1805
2020-05-12,FL,41923,537681,579604,1849
2020-05-13,FL,42402,552361,594763,1898
2020-05-14,FL,43210,565627,608837,1948
2020-05-15,FL,43210,565627,608837,1991
2020-05-16,FL,44811,585236,630047,2040
2020-05-17,FL,45588,606204,651792,2049
2020-05-18,FL,46442,629970,676412,2073
2020-05-19,FL,46944,668911,715855,2129
2020-05-20,FL,47471,723877,771348,2173
2020-05-21,FL,48675,765254,813929,2222
2020-05-22,FL,49451,786045,835496,2268
2020-05-23,FL,50127,806310,856437,2312
2020-05-24,FL,50867,820368,871235,2316
2020-05-25,FL,51746,856489,908235,2331
2020-05-26,FL,52255,870969,923224,2338
2020-05-27,FL,52634,880937,933571,2400
2020-05-28,FL,53285,898331,951616,2446
2020-05-29,FL,54497,928742,983239,2495
2020-05-30,FL,55424,939544,994968,2530
2020-05-31,FL,56163,965186,1021349,2534
2020-06-01,FL,56830,983570,1040400,2543
2020-06-02,FL,57447,992305,1049752,2613
2020-06-03,FL,58764,1022149,1080913,2650
2020-06-04,FL,60183,1046860,1107043,2691
2020-06-05,FL,61488,1073452,1134940,2745
2020-06-06,FL,62758,1111427,1174185,2773
2020-06-07,FL,63938,1152220,1216158,2786
2020-06-08,FL,64904,1169646,1234550,2798
2020-06-09,FL,66000,1192305,1258305,2851
2020-06-10,FL,67371,1211652,1279023,2889
2020-06-11,FL,69069,1237679,1306748,2938
2020-06-12,FL,70971,1264928,1335899,2967
2020-06-13,FL,73552,1296861,1370413,3016
2020-06-14,FL,75568,1333447,1409015,3022
2020-06-15,FL,77326,1352858,1430184,3030
2020-06-16,FL,80109,1380200,1460309,3085
2020-06-17,FL,82719,1403040,1485759,3110
2020-06-18,FL,85926,1425386,1511312,3154
2020-06-19,FL,89748,1443123,1532871,3197
2020-06-20,FL,93797,1467475,1561272,3237
2020-06-21,FL,97291,1502005,1599296,3254
2020-06-22,FL,100217,1517270,1617487,3266
2020-06-23,FL,103503,1537249,1640752,3333
2020-06-24,FL,109014,1559328,1668342,3377
2020-06-25,FL,114018,1606626,1720644,3423
2020-06-26,FL,122960,1645925,1768885,3464
2020-06-27,FL,132545,1696980,1829525,3489
2020-06-28,FL,141075,1740822,1881897,3518
2020-06-29,FL,146341,1766402,1912743,3546
2020-06-30,FL,152434,1792561,1944995,3604
2020-07-01,FL,158997,1821357,1980354,3650
2020-07-02,FL,169106,1863077,2032183,3718
2020-07-03,FL,178594,1902766,2081360,3785
2020-07-04,FL,190052,1956445,2146497,3803
2020-07-05,FL,200111,2000088,2200199,3832
2020-07-06,FL,206447,2027493,2233940,3880
2020-07-07,FL,213794,2055400,2269194,3943
2020-07-08,FL,223783,2096424,2320207,3991
2020-07-09,FL,232718,2124680,2357398,4111
2020-07-10,FL,244151,2177476,2421627,4203
2020-07-11,FL,254511,2220788,2475299,4301
2020-07-12,FL,269811,2304196,2574007,4346
2020-07-13,FL,282435,2357139,2639574,4381
2020-07-14,FL,291629,2393614,2685243,4514
2020-07-15,FL,301810,2434143,2735953,4626
2020-07-16,FL,315775,2499843,2815618,4782
2020-07-17,FL,327241,2553527,2880768,4912
2020-07-18,FL,337569,2594419,2931988,5002
2020-07-19,FL,350047,2652594,3002641,5091
2020-07-20,FL,360394,2691712,3052106,5183
2020-07-21,FL,369834,2729916,3099750,5319
2020-07-22,FL,379619,2775092,3154711,5459
2020-07-23,FL,389868,2821074,3210942,5632
2020-07-24,FL,402312,2874324,3276636,5768
2020-07-25,FL,414511,2921866,3336377,5894
2020-03-04,GA,2,0,2,0
2020-03-05,GA,2,0,2,0
2020-03-06,GA,2,0,2,0
2020-03-07,GA,6,0,6,0
2020-03-08,GA,7,0,7,0
2020-03-09,GA,12,0,12,0
2020-03-10,GA,17,0,17,0
2020-03-11,GA,22,0,22,0
2020-03-12,GA,31,0,31,0
2020-03-13,GA,42,0,42,1
2020-03-14,GA,66,0,66,1
2020-03-15,GA,99,0,99,1
2020-03-16,GA,121,0,121,1
2020-03-17,GA,146,0,146,1
2020-03-18,GA,197,1311,1508,1
2020-03-19,GA,287,1544,1831,10
2020-03-20,GA,420,1966,2386,13
2020-03-21,GA,507,2557,3064,14
2020-03-22,GA,600,3420,4020,23
2020-03-23,GA,772,4297,5069,25
2020-03-24,GA,1026,4458,5484,32
2020-03-25,GA,1247,4932,6179,40
2020-03-26,GA,1525,7401,8926,48
2020-03-27,GA,2001,7864,9865,64
2020-03-28,GA,2366,8685,11051,69
2020-03-29,GA,2651,9913,12564,80
2020-03-30,GA,2809,9915,12724,87
2020-03-31,GA,3929,12252,16181,111
2020-04-01,GA,4638,15688,20326,139
2020-04-02,GA,5348,17609,22957,163
2020-04-03,GA,5831,19434,25265,184
2020-04-04,GA,6160,20134,26294,201
2020-04-05,GA,6647,21185,27832,211
2020-04-06,GA,7314,23960,31274,229
2020-04-07,GA,8818,24895,33713,329
2020-04-08,GA,9901,28886,38787,362
2020-04-09,GA,10566,30519,41085,379
2020-04-10,GA,11483,34664,46147,416
2020-04-11,GA,12159,39556,51715,428
2020-04-12,GA,12452,42001,54453,433
2020-04-13,GA,13315,43706,57021,464
2020-04-14,GA,14223,47572,61795,501
2020-04-15,GA,14987,49103,64090,552
2020-04-16,GA,15669,52270,67939,587
2020-04-17,GA,17194,54490,71684,650
2020-04-18,GA,17669,56539,74208,673
2020-04-19,GA,18301,61632,79933,687
2020-04-20,GA,18947,65381,84328,733
2020-04-21,GA,19881,68259,88140,799
2020-04-22,GA,20740,73332,94072,836
2020-04-23,GA,21512,79550,101062,872
2020-04-24,GA,22147,85029,107176,892
2020-04-25,GA,22695,96319,119014,904
2020-04-26,GA,23401,99822,123223,912
2020-04-27,GA,23913,103256,127169,971
2020-04-28,GA,24615,115405,140020,1026
2020-04-29,GA,25623,118155,143778,1093
2020-04-30,GA,26155,122889,149044,1120
2020-05-01,GA,27270,141097,168367,1154
2020-05-02,GA,28306,146494,174800,1174
2020-05-03,GA,28602,146494,175096,1177
2020-05-04,GA,29368,153957,183325,1222
2020-05-05,GA,29711,171172,200883,1288
2020-05-06,GA,30696,173441,204137,1311
2020-05-07,GA,31439,185864,217303,1336
2020-05-08,GA,32106,195461,227567,1377
2020-05-09,GA,32532,202792,235324,1400
2020-05-10,GA,33441,210106,243547,1405
2020-05-11,GA,33927,217361,251288,1441
2020-05-12,GA,34635,227544,262179,1461
2020-05-13,GA,35332,238572,273904,1505
2020-05-14,GA,35858,250023,285881,1527
2020-05-15,GA,36681,265193,301874,1557
2020-05-16,GA,37147,283922,321069,1592
2020-05-17,GA,37701,313474,351175,1606
2020-05-18,GA,38081,326208,364289,1642
2020-05-19,GA,38721,339435,378156,1664
2020-05-20,GA,39647,363293,402940,1687
2020-05-21,GA,40405,367326,407731,1754
2020-05-22,GA,41218,386031,427249,1785
2020-05-23,GA,42132,411405,453537,1811
2020-05-24,GA,42838,439116,481954,1824
2020-05-25,GA,43344,470201,513545,1830
2020-05-26,GA,43730,471215,514945,1871
2020-05-27,GA,44421,396335,440756,1907
2020-05-28,GA,45070,399576,444646,1962
2020-05-29,GA,45670,404601,450271,1974
2020-05-30,GA,46286,408552,454838,2003
2020-05-31,GA,46986,418539,465525,2042
2020-06-01,GA,47618,424013,471631,2074
2020-06-02,GA,48207,426080,474287,2102
2020-06-03,GA,48894,433818,482712,2123
2020-06-04,GA,49847,446484,496331,2147
2020-06-05,GA,50621,457167,507788,2174
2020-06-06,GA,51309,471548,522857,2174
2020-06-07,GA,51898,487986,539884,2180
2020-06-08,GA,52497,496878,549375,2208
2020-06-09,GA,53249,503934,557183,2285
2020-06-10,GA,53980,516975,570955,2329
2020-06-11,GA,54973,529268,584241,2375
2020-06-12,GA,55783,536175,591958,2418
2020-06-13,GA,56801,542879,599680,2446
2020-06-14,GA,57681,563109,620790,2451
2020-06-15,GA,58414,572082,630496,2494
2020-06-16,GA,59078,575900,634978,2529
2020-06-17,GA,60030,590437,650467,2575
2020-06-18,GA,60912,602292,663204,2605
2020-06-19,GA,62009,608297,670306,2636
2020-06-20,GA,63809,630575,694384,2642
2020-06-21,GA,64701,633606,698307,2643
2020-06-22,GA,65928,642098,708026,2648
2020-06-23,GA,67678,663583,731261,2688
2020-06-24,GA,69381,673853,743234,2698
2020-06-25,GA,71095,686829,757924,2745
2020-06-26,GA,72995,698033,771028,2770
2020-06-27,GA,74985,714828,789813,2776
2020-06-28,GA,77210,729728,806938,2778
2020-06-29,GA,79417,743700,823117,2784
2020-06-30,GA,81291,752587,833878,2805
2020-07-01,GA,84237,770801,855038,2827
2020-07-02,GA,87709,795530,883239,2849
2020-07-03,GA,90493,810724,901217,2856
2020-07-04,GA,93319,833040,926359,2857
2020-07-05,GA,95516,853669,949185,2860
2020-07-06,GA,97064,861889,958953,2878
2020-07-07,GA,100470,878982,979452,2899
2020-07-08,GA,103890,896519,1000409,2922
2020-07-09,GA,106727,912695,1019422,2930
2020-07-10,GA,111211,935137,1046348,2965
2020-07-11,GA,114401,950472,1064873,2996
2020-07-12,GA,116926,966490,1083416,3001
2020-07-13,GA,120569,987398,1107967,3026
2020-07-14,GA,123963,1007071,1131034,3054
2020-07-15,GA,127834,1027149,1154983,3091
2020-07-16,GA,131275,1046947,1178222,3104
2020-07-17,GA,135183,1063495,1198678,3132
2020-07-18,GA,139872,1091934,1231806,3168
2020-07-19,GA,143123,1112196,1255319,3173
2020-07-20,GA,145575,1128206,1273781,3176
2020-07-21,GA,148988,1146303,1295291,3254
2020-07-22,GA,152302,1164542,1316844,3335
2020-07-23,GA,156588,1180350,1336938,3360
2020-07-24,GA,161401,1221043,1382444,3442
2020-07-25,GA,165188,1242652,1407840,3495
2020-03-16,GU,3,23,26,0
2020-03-17,GU,5,41,46,0
2020-03-18,GU,8,57,65,0
2020-03-19,GU,12,69,81,0
2020-03-20,GU,14,86,100,0
2020-03-21,GU,15,108,123,0
2020-03-22,GU,27,126,153,1
2020-03-23,GU,29,161,190,1
2020-03-24,GU,32,201,233,1
2020-03-25,GU,37,233,270,1
2020-03-26,GU,45,263,308,1
2020-03-27,GU,51,299,350,1
2020-03-28,GU,55,299,354,1
2020-03-29,GU,56,334,390,1
2020-03-30,GU,58,352,410,1
2020-03-31,GU,69,371,440,2
2020-04-01,GU,77,406,483,3
2020-04-02,GU,82,442,524,3
2020-04-03,GU,84,459,543,4
2020-04-04,GU,93,472,565,4
2020-04-05,GU,112,493,605,4
2020-04-06,GU,113,505,618,4
2020-04-07,GU,121,529,650,4
2020-04-08,GU,125,562,687,4
2020-04-09,GU,128,593,721,4
2020-04-10,GU,130,662,792,4
2020-04-11,GU,133,693,826,5
2020-04-12,GU,133,693,826,5
2020-04-13,GU,133,770,903,5
2020-04-14,GU,133,811,944,5
2020-04-15,GU,133,843,976,5
2020-04-16,GU,133,870,1003,5
2020-04-17,GU,133,940,1073,5
2020-04-18,GU,133,943,1076,5
2020-04-19,GU,133,943,1076,5
2020-04-20,GU,133,991,1124,5
2020-04-21,GU,133,1033,1166,5
2020-04-22,GU,134,1086,1220,5
2020-04-23,GU,135,1180,1315,5
2020-04-24,GU,141,1233,1374,5
2020-04-25,GU,141,1308,1449,5
2020-04-26,GU,141,1387,1528,5
2020-04-27,GU,144,1424,1568,5
2020-04-28,GU,145,1538,1683,5
2020-04-29,GU,145,1702,1847,5
2020-04-30,GU,146,1962,2108,5
2020-05-01,GU,146,2859,3005,5
2020-05-02,GU,148,3040,3188,5
2020-05-03,GU,150,3152,3302,5
2020-05-04,GU,149,3242,3391,5
2020-05-05,GU,149,3341,3490,5
2020-05-06,GU,151,3476,3627,5
2020-05-07,GU,151,3564,3715,5
2020-05-08,GU,151,3626,3777,5
2020-05-09,GU,151,3643,3794,5
2020-05-10,GU,151,3643,3794,5
2020-05-11,GU,151,3838,3989,5
2020-05-12,GU,152,3939,4091,5
2020-05-13,GU,152,4110,4262,5
2020-05-14,GU,153,4226,4379,5
2020-05-15,GU,154,4361,4515,5
2020-05-16,GU,154,4365,4519,5
2020-05-17,GU,154,4450,4604,5
2020-05-18,GU,154,4569,4723,5
2020-05-19,GU,154,4673,4827,5
2020-05-20,GU,165,4807,4972,5
2020-05-21,GU,165,4899,5064,5
2020-05-22,GU,165,5114,5279,5
2020-05-23,GU,165,5194,5359,5
2020-05-24,GU,166,5403,5569,5
2020-05-25,GU,166,5403,5569,5
2020-05-26,GU,169,5515,5684,5
2020-05-27,GU,170,5515,5685,5
2020-05-28,GU,172,5790,5962,5
2020-05-29,GU,172,5923,6095,5
2020-05-30,GU,173,5929,6102,5
2020-05-31,GU,173,5929,6102,5
2020-06-01,GU,175,6141,6316,5
2020-06-02,GU,177,6214,6391,5
2020-06-03,GU,178,6549,6727,5
2020-06-04,GU,179,6805,6984,5
2020-06-05,GU,179,7195,7374,5
2020-06-06,GU,179,7284,7463,5
2020-06-07,GU,179,7284,7463,5
2020-06-08,GU,179,7550,7729,5
2020-06-09,GU,180,7796,7976,5
2020-06-10,GU,182,8100,8282,5
2020-06-11,GU,183,8197,8380,5
2020-06-12,GU,184,8343,8527,5
2020-06-13,GU,185,8358,8543,5
2020-06-14,GU,185,8358,8543,5
2020-06-15,GU,185,8573,8758,5
2020-06-16,GU,186,8846,9032,5
2020-06-17,GU,188,9010,9198,5
2020-06-18,GU,193,9395,9588,5
2020-06-19,GU,200,9515,9715,5
2020-06-20,GU,222,9788,10010,5
2020-06-21,GU,222,9788,10010,5
2020-06-22,GU,224,10180,10404,5
2020-06-23,GU,225,10426,10651,5
2020-06-24,GU,231,10807,11038,5
2020-06-25,GU,245,11173,11418,5
2020-06-26,GU,248,11644,11892,5
2020-06-27,GU,248,11903,12151,5
2020-06-28,GU,248,12130,12378,5
2020-06-29,GU,255,12659,12914,5
2020-06-30,GU,259,13056,13315,5
2020-07-01,GU,267,13517,13784,5
2020-07-02,GU,280,13653,13933,5
2020-07-03,GU,286,14263,14549,5
2020-07-04,GU,288,14666,14954,5
2020-07-05,GU,288,14666,14954,5
2020-07-06,GU,301,15248,15549,5
2020-07-07,GU,303,15608,15911,5
2020-07-08,GU,307,15833,16140,5
2020-07-09,GU,309,16223,16532,5
2020-07-10,GU,310,16556,16866,5
2020-07-11,GU,312,16667,16979,5
2020-07-12,GU,312,16667,16979,5
2020-07-13,GU,312,17030,17342,5
2020-07-14,GU,312,17225,17537,5
2020-07-15,GU,313,17514,17827,5
2020-07-16,GU,314,17697,18011,5
2020-07-17,GU,314,17938,18252,5
2020-07-18,GU,315,17938,18253,5
2020-07-19,GU,315,17938,18253,5
2020-07-20,GU,319,18252,18571,5
2020-07-21,GU,327,18430,18757,5
2020-07-22,GU,330,18752,19082,5
2020-07-23,GU,332,19132,19464,5
2020-07-24,GU,337,19132,19469,5
2020-07-25,GU,337,19695,20032,5
2020-03-07,HI,1,0,1,0
2020-03-08,HI,1,0,1,0
2020-03-09,HI,2,0,2,0
2020-03-10,HI,2,0,2,0
2020-03-11,HI,2,0,2,0
2020-03-12,HI,2,0,2,0
2020-03-13,HI,2,0,2,0
2020-03-14,HI,2,0,2,0
2020-03-15,HI,2,0,2,0
2020-03-16,HI,7,0,7,0
2020-03-17,HI,10,0,10,0
2020-03-18,HI,14,93,107,0
2020-03-19,HI,16,93,109,0
2020-03-20,HI,26,124,150,0
2020-03-21,HI,37,124,161,0
2020-03-22,HI,48,263,311,0
2020-03-23,HI,56,2955,3011,0
2020-03-24,HI,77,3589,3666,0
2020-03-25,HI,90,4357,4447,0
2020-03-26,HI,95,4357,4452,0
2020-03-27,HI,106,4357,4463,0
2020-03-28,HI,120,4357,4477,0
2020-03-29,HI,151,6849,7000,0
2020-03-30,HI,175,7825,8000,0
2020-03-31,HI,204,8471,8675,0
2020-04-01,HI,208,8721,8929,1
2020-04-02,HI,258,10206,10464,1
2020-04-03,HI,285,10206,10491,2
2020-04-04,HI,319,11959,12278,3
2020-04-05,HI,351,12604,12955,4
2020-04-06,HI,371,13155,13526,4
2020-04-07,HI,387,13155,13542,5
2020-04-08,HI,410,14739,15149,5
2020-04-09,HI,435,15316,15751,5
2020-04-10,HI,442,15707,16149,6
2020-04-11,HI,465,17066,17531,8
2020-04-12,HI,486,17482,17968,8
2020-04-13,HI,499,18345,18844,9
2020-04-14,HI,504,18916,19420,9
2020-04-15,HI,517,19286,19803,9
2020-04-16,HI,530,20170,20700,9
2020-04-17,HI,541,21316,21857,9
2020-04-18,HI,553,21790,22343,9
2020-04-19,HI,574,22896,23470,9
2020-04-20,HI,580,23595,24175,10
2020-04-21,HI,584,24112,24696,10
2020-04-22,HI,586,24760,25346,12
2020-04-23,HI,592,25536,26128,12
2020-04-24,HI,596,26291,26887,12
2020-04-25,HI,601,27439,28040,13
2020-04-26,HI,603,27880,28483,14
2020-04-27,HI,606,28404,29010,14
2020-04-28,HI,607,28576,29183,16
2020-04-29,HI,609,29009,29618,16
2020-04-30,HI,613,30027,30640,16
2020-05-01,HI,618,30476,31094,16
2020-05-02,HI,619,31366,31985,16
2020-05-03,HI,620,32330,32950,16
2020-05-04,HI,620,33246,33866,17
2020-05-05,HI,621,33378,33999,17
2020-05-06,HI,625,34574,35199,17
2020-05-07,HI,626,34915,35541,17
2020-05-08,HI,629,35989,36618,17
2020-05-09,HI,629,35633,36262,17
2020-05-10,HI,631,36639,37270,17
2020-05-11,HI,632,37051,37683,17
2020-05-12,HI,634,37305,37939,17
2020-05-13,HI,635,37730,38365,17
2020-05-14,HI,638,38243,38881,17
2020-05-15,HI,637,38139,38776,17
2020-05-16,HI,638,40245,40883,17
2020-05-17,HI,639,41035,41674,17
2020-05-18,HI,640,41405,42045,17
2020-05-19,HI,640,44383,45023,17
2020-05-20,HI,641,45663,46304,17
2020-05-21,HI,643,46506,47149,17
2020-05-22,HI,647,47338,47985,17
2020-05-23,HI,642,48179,48821,17
2020-05-24,HI,643,48929,49572,17
2020-05-25,HI,643,49728,50371,17
2020-05-26,HI,643,49728,50371,17
2020-05-27,HI,643,50559,51202,17
2020-05-28,HI,644,51195,51839,17
2020-05-29,HI,647,52177,52824,17
2020-05-30,HI,649,53365,54014,17
2020-05-31,HI,651,53969,54620,17
2020-06-01,HI,652,47835,48487,17
2020-06-02,HI,652,48269,48921,17
2020-06-03,HI,653,48855,49508,17
2020-06-04,HI,653,49985,50638,17
2020-06-05,HI,655,51681,52336,17
2020-06-06,HI,664,52593,53257,17
2020-06-07,HI,673,53382,54055,17
2020-06-08,HI,675,54472,55147,17
2020-06-09,HI,676,54798,55474,17
2020-06-10,HI,682,55491,56173,17
2020-06-11,HI,685,56610,57295,17
2020-06-12,HI,692,57887,58579,17
2020-06-13,HI,706,58632,59338,17
2020-06-14,HI,723,59599,60322,17
2020-06-15,HI,728,60746,61474,17
2020-06-16,HI,736,61292,62028,17
2020-06-17,HI,740,62503,63243,17
2020-06-18,HI,744,63630,64374,17
2020-06-19,HI,762,64982,65744,17
2020-06-20,HI,789,65945,66734,17
2020-06-21,HI,803,67057,67860,17
2020-06-22,HI,814,67897,68711,17
2020-06-23,HI,816,68524,69340,17
2020-06-24,HI,819,69720,70539,17
2020-06-25,HI,835,71100,71935,17
2020-06-26,HI,850,72155,73005,17
2020-06-27,HI,866,73435,74301,17
2020-06-28,HI,872,74606,75478,18
2020-06-29,HI,899,76256,77155,18
2020-06-30,HI,900,76843,77743,18
2020-07-01,HI,917,78141,79058,18
2020-07-02,HI,926,79364,80290,18
2020-07-03,HI,946,80672,81618,18
2020-07-04,HI,975,82501,83476,19
2020-07-05,HI,999,83326,84325,19
2020-07-06,HI,1023,84035,85058,19
2020-07-07,HI,1030,84643,85673,19
2020-07-08,HI,1071,86025,87096,19
2020-07-09,HI,1094,88058,89152,19
2020-07-10,HI,1130,89465,90595,19
2020-07-11,HI,1158,91076,92234,19
2020-07-12,HI,1200,92720,93920,19
2020-07-13,HI,1220,93950,95170,19
2020-07-14,HI,1243,94827,96070,22
2020-07-15,HI,1264,96293,97557,22
2020-07-16,HI,1292,98095,99387,22
2020-07-17,HI,1311,99893,101204,22
2020-07-18,HI,1334,101661,102995,23
2020-07-19,HI,1354,103281,104635,24
2020-07-20,HI,1381,104575,105956,24
2020-07-21,HI,1393,105390,106783,24
2020-07-22,HI,1418,106764,108182,24
2020-07-23,HI,1435,107378,108813,25
2020-07-24,HI,1490,109801,111291,26
2020-07-25,HI,1549,111241,112790,26
2020-03-06,IA,0,15,15,0
2020-03-07,IA,0,15,15,0
2020-03-08,IA,0,15,15,0
2020-03-09,IA,3,26,29,0
2020-03-10,IA,8,32,40,0
2020-03-11,IA,13,46,59,0
2020-03-12,IA,14,67,81,0
2020-03-13,IA,16,83,99,0
2020-03-14,IA,17,83,100,0
2020-03-15,IA,18,83,101,0
2020-03-16,IA,22,83,105,0
2020-03-17,IA,23,83,106,0
2020-03-18,IA,29,83,112,0
2020-03-19,IA,38,83,121,0
2020-03-20,IA,45,642,687,0
2020-03-21,IA,68,1049,1117,0
2020-03-22,IA,90,1215,1305,0
2020-03-23,IA,105,2043,2148,0
2020-03-24,IA,124,2315,2439,0
2020-03-25,IA,145,2578,2723,1
2020-03-26,IA,179,2578,2757,1
2020-03-27,IA,235,3740,3975,3
2020-03-28,IA,298,4375,4673,3
2020-03-29,IA,336,5013,5349,4
2020-03-30,IA,424,6162,6586,6
2020-03-31,IA,497,6888,7385,7
2020-04-01,IA,549,7304,7853,9
2020-04-02,IA,614,8054,8668,11
2020-04-03,IA,699,8754,9453,11
2020-04-04,IA,786,9454,10240,14
2020-04-05,IA,868,9973,10841,22
2020-04-06,IA,946,10653,11599,25
2020-04-07,IA,1048,11670,12718,26
2020-04-08,IA,1145,12821,13966,27
2020-04-09,IA,1270,13703,14973,29
2020-04-10,IA,1388,14565,15953,31
2020-04-11,IA,1510,15622,17132,34
2020-04-12,IA,1587,16005,17592,41
2020-04-13,IA,1710,16986,18696,43
2020-04-14,IA,1899,16986,18885,49
2020-04-15,IA,1995,17874,19869,53
2020-04-16,IA,2141,18534,20675,60
2020-04-17,IA,2332,19460,21792,64
2020-04-18,IA,2513,20434,22947,74
2020-04-19,IA,2902,21648,24550,75
2020-04-20,IA,3159,22661,25820,79
2020-04-21,IA,3641,23974,27615,83
2020-04-22,IA,3748,24496,28244,90
2020-04-23,IA,3924,25338,29262,96
2020-04-24,IA,4445,27528,31973,107
2020-04-25,IA,5092,29258,34350,112
2020-04-26,IA,5476,30614,36090,118
2020-04-27,IA,5868,32282,38150,127
2020-04-28,IA,6376,33447,39823,136
2020-04-29,IA,6843,34494,41337,148
2020-04-30,IA,7145,35522,42667,162
2020-05-01,IA,7884,37708,45592,170
2020-05-02,IA,8641,37708,46349,175
2020-05-03,IA,9169,44017,53186,184
2020-05-04,IA,9703,47458,57161,188
2020-05-05,IA,10111,50458,60569,207
2020-05-06,IA,10404,52767,63171,219
2020-05-07,IA,11059,55368,66427,231
2020-05-08,IA,11457,58804,70261,243
2020-05-09,IA,11671,59805,71476,252
2020-05-10,IA,11959,62215,74174,265
2020-05-11,IA,12373,65419,77792,271
2020-05-12,IA,12912,68376,81288,289
2020-05-13,IA,13289,72430,85719,306
2020-05-14,IA,13675,75619,89294,318
2020-05-15,IA,14049,79517,93566,336
2020-05-16,IA,14328,81972,96300,346
2020-05-17,IA,14651,85590,100241,351
2020-05-18,IA,14955,88193,103148,355
2020-05-19,IA,15349,92299,107648,372
2020-05-20,IA,15614,95134,110748,388
2020-05-21,IA,16170,100395,116565,406
2020-05-22,IA,16504,103746,120250,425
2020-05-23,IA,16893,107048,123941,444
2020-05-24,IA,17252,110504,127756,454
2020-05-25,IA,17577,115138,132715,459
2020-05-26,IA,17703,117301,135004,478
2020-05-27,IA,18360,121166,139526,491
2020-05-28,IA,18573,124360,142933,504
2020-05-29,IA,18926,128394,147320,522
2020-05-30,IA,19244,131179,150423,531
2020-05-31,IA,19552,136744,156296,534
2020-06-01,IA,19697,139384,159081,551
2020-06-02,IA,20016,143674,163690,561
2020-06-03,IA,20055,144390,164445,574
2020-06-04,IA,20805,154130,174935,580
2020-06-05,IA,21152,159511,180663,592
2020-06-06,IA,21478,163236,184714,598
2020-06-07,IA,21667,166525,188192,604
2020-06-08,IA,21987,171635,193622,612
2020-06-09,IA,22236,175487,197723,624
2020-06-10,IA,22551,180278,202829,630
2020-06-11,IA,22938,185601,208539,639
2020-06-12,IA,23337,191207,214544,643
2020-06-13,IA,23717,195891,219608,650
2020-06-14,IA,23926,200708,224634,652
2020-06-15,IA,24053,203335,227388,655
2020-06-16,IA,24179,206459,230638,669
2020-06-17,IA,24461,210670,235131,673
2020-06-18,IA,24854,216077,240931,679
2020-06-19,IA,25275,221374,246649,681
2020-06-20,IA,25496,224711,250207,681
2020-06-21,IA,25963,231189,257152,685
2020-06-22,IA,26051,232581,258632,686
2020-06-23,IA,26373,238330,264703,688
2020-06-24,IA,26705,243254,269959,692
2020-06-25,IA,27197,249857,277054,695
2020-06-26,IA,27686,255957,283643,704
2020-06-27,IA,28012,261740,289752,704
2020-06-28,IA,28489,267426,295915,705
2020-06-29,IA,28782,272063,300845,708
2020-06-30,IA,29007,275181,304188,715
2020-07-01,IA,29451,280339,309790,717
2020-07-02,IA,30209,287329,317538,718
2020-07-03,IA,30429,291032,321461,720
2020-07-04,IA,31041,297970,329011,721
2020-07-05,IA,31353,301119,332472,721
2020-07-06,IA,31657,303805,335462,723
2020-07-07,IA,32029,307269,339298,725
2020-07-08,IA,32509,313842,346351,735
2020-07-09,IA,33240,321419,354659,739
2020-07-10,IA,33984,328264,362248,743
2020-07-11,IA,34647,333714,368361,748
2020-07-12,IA,35071,339342,374413,750
2020-07-13,IA,35529,341187,376716,754
2020-07-14,IA,35849,344559,380408,757
2020-07-15,IA,36291,351021,387312,762
2020-07-16,IA,37132,359319,396451,778
2020-07-17,IA,37722,364731,402453,784
2020-07-18,IA,37907,365822,403729,787
2020-07-19,IA,38723,376768,415491,794
2020-07-20,IA,39166,379378,418544,797
2020-07-21,IA,39474,382959,422433,802
2020-07-22,IA,39793,386643,426436,808
2020-07-23,IA,40634,395652,436286,818
2020-07-24,IA,41271,400602,441873,823
2020-07-25,IA,41671,404592,446263,826
2020-03-07,ID,0,27,27,0
2020-03-08,ID,0,27,27,0
2020-03-09,ID,0,41,41,0
2020-03-10,ID,0,41,41,0
2020-03-11,ID,0,67,67,0
2020-03-12,ID,0,93,93,0
2020-03-13,ID,0,131,131,0
2020-03-14,ID,2,174,176,0
2020-03-15,ID,5,174,179,0
2020-03-16,ID,5,265,270,0
2020-03-17,ID,7,346,353,0
2020-03-18,ID,9,459,468,0
2020-03-19,ID,11,459,470,0
2020-03-20,ID,23,590,613,0
2020-03-21,ID,31,880,911,0
2020-03-22,ID,42,1175,1217,0
2020-03-23,ID,47,1309,1356,0
2020-03-24,ID,50,1887,1937,0
2020-03-25,ID,73,1887,1960,0
2020-03-26,ID,123,2065,2188,0
2020-03-27,ID,189,2668,2857,3
2020-03-28,ID,230,3342,3572,4
2020-03-29,ID,261,4021,4282,5
2020-03-30,ID,310,4396,4706,6
2020-03-31,ID,415,5297,5712,7
2020-04-01,ID,525,6076,6601,9
2020-04-02,ID,669,6613,7282,9
2020-04-03,ID,891,7054,7945,9
2020-04-04,ID,1013,7857,8870,10
2020-04-05,ID,1077,9184,10261,10
2020-04-06,ID,1101,9894,10995,10
2020-04-07,ID,1170,10076,11246,13
2020-04-08,ID,1210,10688,11898,15
2020-04-09,ID,1232,11299,12531,18
2020-04-10,ID,1353,11741,13094,24
2020-04-11,ID,1396,12368,13764,25
2020-04-12,ID,1407,12901,14308,27
2020-04-13,ID,1426,13455,14881,27
2020-04-14,ID,1453,13661,15114,33
2020-04-15,ID,1464,13934,15398,39
2020-04-16,ID,1587,14655,16242,41
2020-04-17,ID,1609,15043,16652,41
2020-04-18,ID,1655,15292,16947,43
2020-04-19,ID,1668,15773,17441,44
2020-04-20,ID,1672,15773,17445,45
2020-04-21,ID,1736,16071,17807,48
2020-04-22,ID,1766,16404,18170,51
2020-04-23,ID,1802,17370,19172,54
2020-04-24,ID,1836,17611,19447,54
2020-04-25,ID,1870,17611,19481,54
2020-04-26,ID,1887,17611,19498,56
2020-04-27,ID,1897,18127,20024,56
2020-04-28,ID,1917,18135,20052,58
2020-04-29,ID,1952,26430,28382,60
2020-04-30,ID,1984,26862,28846,60
2020-05-01,ID,2015,27210,29225,63
2020-05-02,ID,2035,27455,29490,63
2020-05-03,ID,2061,27746,29807,63
2020-05-04,ID,2061,27746,29807,64
2020-05-05,ID,2106,28202,30308,64
2020-05-06,ID,2127,28418,30545,65
2020-05-07,ID,2158,28732,30890,66
2020-05-08,ID,2178,29092,31270,67
2020-05-09,ID,2205,29601,31806,67
2020-05-10,ID,2230,29912,32142,67
2020-05-11,ID,2230,29912,32142,67
2020-05-12,ID,2260,30445,32705,70
2020-05-13,ID,2293,30835,33128,69
2020-05-14,ID,2324,31430,33754,69
2020-05-15,ID,2351,32394,34745,72
2020-05-16,ID,2389,33299,35688,73
2020-05-17,ID,2419,34253,36672,73
2020-05-18,ID,2419,34253,36672,73
2020-05-19,ID,2455,35614,38069,74
2020-05-20,ID,2476,36091,38567,77
2020-05-21,ID,2506,36382,38888,77
2020-05-22,ID,2534,37061,39595,77
2020-05-23,ID,2595,38014,40609,79
2020-05-24,ID,2626,38780,41406,79
2020-05-25,ID,2626,38780,41406,79
2020-05-26,ID,2626,38780,41406,79
2020-05-27,ID,2699,40318,43017,81
2020-05-28,ID,2731,41144,43875,82
2020-05-29,ID,2769,41992,44761,82
2020-05-30,ID,2803,42621,45424,82
2020-05-31,ID,2839,43858,46697,82
2020-06-01,ID,2839,43858,46697,82
2020-06-02,ID,2906,45227,48133,83
2020-06-03,ID,2933,46009,48942,83
2020-06-04,ID,2990,46815,49805,83
2020-06-05,ID,3054,50570,53624,83
2020-06-06,ID,3111,52128,55239,83
2020-06-07,ID,3139,52902,56041,83
2020-06-08,ID,3139,52902,56041,83
2020-06-09,ID,3189,54488,57677,83
2020-06-10,ID,3220,55832,59052,85
2020-06-11,ID,3260,56855,60115,85
2020-06-12,ID,3302,58130,61432,86
2020-06-13,ID,3353,59305,62658,87
2020-06-14,ID,3399,59581,62980,87
2020-06-15,ID,3399,59581,62980,87
2020-06-16,ID,3462,62185,65647,88
2020-06-17,ID,3540,63244,66784,88
2020-06-18,ID,3632,64380,68012,88
2020-06-19,ID,3743,65802,69545,89
2020-06-20,ID,3871,67325,71196,89
2020-06-21,ID,4006,68962,72968,89
2020-06-22,ID,4006,68962,72968,89
2020-06-23,ID,4254,71910,76164,89
2020-06-24,ID,4402,73433,77835,89
2020-06-25,ID,4645,75894,80539,90
2020-06-26,ID,4865,77505,82370,90
2020-06-27,ID,5148,78908,84056,90
2020-06-28,ID,5319,81026,86345,91
2020-06-29,ID,5319,81026,86345,91
2020-06-30,ID,5752,83551,89303,91
2020-07-01,ID,6117,84923,91040,92
2020-07-02,ID,6370,88751,95121,92
2020-07-03,ID,6593,92116,98709,92
2020-07-04,ID,6994,94073,101067,93
2020-07-05,ID,7370,96896,104266,93
2020-07-06,ID,7733,98732,106465,93
2020-07-07,ID,8052,100489,108541,94
2020-07-08,ID,8539,102792,111331,94
2020-07-09,ID,8969,105651,114620,98
2020-07-10,ID,9428,108650,118078,100
2020-07-11,ID,9928,112421,122349,101
2020-07-12,ID,10505,114756,125261,102
2020-07-13,ID,10902,116230,127132,102
2020-07-14,ID,11402,118882,130284,102
2020-07-15,ID,11718,122196,133914,103
2020-07-16,ID,12445,124418,136863,110
2020-07-17,ID,13133,127186,140319,114
2020-07-18,ID,13752,128753,142505,118
2020-07-19,ID,14302,131884,146186,119
2020-07-20,ID,14873,133015,147888,119
2020-07-21,ID,15266,135805,151071,122
2020-07-22,ID,15822,138149,153971,126
2020-07-23,ID,16322,140504,156826,135
2020-07-24,ID,16736,143457,160193,138
2020-07-25,ID,17264,146176,163440,144
2020-03-04,IL,4,124,128,0
2020-03-05,IL,5,165,170,0
2020-03-06,IL,5,180,185,0
2020-03-07,IL,6,191,197,0
2020-03-08,IL,6,191,197,0
2020-03-09,IL,7,191,198,0
2020-03-10,IL,19,244,263,0
2020-03-11,IL,19,244,263,0
2020-03-12,IL,25,266,291,0
2020-03-13,IL,32,294,326,0
2020-03-14,IL,46,316,362,0
2020-03-15,IL,64,449,513,0
2020-03-16,IL,93,932,1025,0
2020-03-17,IL,159,1340,1499,1
2020-03-18,IL,288,1763,2051,1
2020-03-19,IL,422,2725,3147,4
2020-03-20,IL,585,3696,4281,5
2020-03-21,IL,753,5488,6241,6
2020-03-22,IL,1049,7271,8320,9
2020-03-23,IL,1273,8583,9856,12
2020-03-24,IL,1535,9934,11469,16
2020-03-25,IL,1865,12344,14209,19
2020-03-26,IL,2538,14093,16631,26
2020-03-27,IL,3026,18516,21542,34
2020-03-28,IL,3491,22000,25491,47
2020-03-29,IL,4596,23166,27762,65
2020-03-30,IL,5057,25389,30446,73
2020-03-31,IL,5994,29231,35225,99
2020-04-01,IL,6980,33404,40384,141
2020-04-02,IL,7695,35961,43656,157
2020-04-03,IL,8904,39144,48048,210
2020-04-04,IL,10357,43224,53581,243
2020-04-05,IL,11256,47727,58983,274
2020-04-06,IL,12262,50680,62942,307
2020-04-07,IL,13549,55183,68732,380
2020-04-08,IL,15078,59988,75066,462
2020-04-09,IL,16422,64435,80857,528
2020-04-10,IL,17887,69640,87527,596
2020-04-11,IL,19180,72969,92149,677
2020-04-12,IL,20852,79883,100735,720
2020-04-13,IL,22025,83743,105768,794
2020-04-14,IL,23247,87369,110616,868
2020-04-15,IL,24593,92336,116929,948
2020-04-16,IL,25733,96856,122589,1072
2020-04-17,IL,27575,102588,130163,1134
2020-04-18,IL,29160,108244,137404,1259
2020-04-19,IL,30357,112961,143318,1290
2020-04-20,IL,31508,116850,148358,1349
2020-04-21,IL,33059,121938,154997,1468
2020-04-22,IL,35108,129238,164346,1565
2020-04-23,IL,36934,136382,173316,1688
2020-04-24,IL,39658,149974,189632,1795
2020-04-25,IL,41777,159840,201617,1874
2020-04-26,IL,43903,171049,214952,1933
2020-04-27,IL,45883,181745,227628,1983
2020-04-28,IL,48102,194087,242189,2125
2020-04-29,IL,50355,206312,256667,2215
2020-04-30,IL,52918,216949,269867,2355
2020-05-01,IL,56055,228633,284688,2457
2020-05-02,IL,58505,241391,299896,2559
2020-05-03,IL,61499,257814,319313,2618
2020-05-04,IL,63840,269307,333147,2662
2020-05-05,IL,65962,280324,346286,2838
2020-05-06,IL,68232,293028,361260,2974
2020-05-07,IL,70873,308170,379043,3111
2020-05-08,IL,73760,325954,399714,3241
2020-05-09,IL,76085,340246,416331,3349
2020-05-10,IL,77741,352243,429984,3406
2020-05-11,IL,79007,363418,442425,3459
2020-05-12,IL,83021,388670,471691,3601
2020-05-13,IL,84698,404661,489359,3792
2020-05-14,IL,87937,424100,512037,3928
2020-05-15,IL,90369,448233,538602,4058
2020-05-16,IL,92457,469192,561649,4129
2020-05-17,IL,94191,487753,581944,4177
2020-05-18,IL,96485,506756,603241,4234
2020-05-19,IL,98030,523654,621684,4379
2020-05-20,IL,100418,542295,642713,4525
2020-05-21,IL,102686,569334,672020,4607
2020-05-22,IL,105444,591689,697133,4715
2020-05-23,IL,107796,614451,722247,4790
2020-05-24,IL,110304,637617,747921,4856
2020-05-25,IL,112017,657547,769564,4884
2020-05-26,IL,113195,673599,786794,4923
2020-05-27,IL,114306,689667,803973,5083
2020-05-28,IL,115833,714133,829966,5186
2020-05-29,IL,117455,734307,851762,5270
2020-05-30,IL,118917,758188,877105,5330
2020-05-31,IL,120260,777999,898259,5390
2020-06-01,IL,121234,797039,918273,5412
2020-06-02,IL,122848,811856,934704,5525
2020-06-03,IL,123830,835345,959175,5621
2020-06-04,IL,124759,857257,982016,5736
2020-06-05,IL,125915,875004,1000919,5795
2020-06-06,IL,126890,895184,1022074,5864
2020-06-07,IL,127757,915017,1042774,5904
2020-06-08,IL,129139,930458,1059597,6102
2020-06-09,IL,129936,949970,1079906,6196
2020-06-10,IL,130561,970165,1100726,6273
2020-06-11,IL,131327,991724,1123051,6363
2020-06-12,IL,132059,1015903,1147962,6441
2020-06-13,IL,132732,1037074,1169806,6470
2020-06-14,IL,133404,1058442,1191846,6489
2020-06-15,IL,133877,1076596,1210473,6507
2020-06-16,IL,134500,1094702,1229202,6579
2020-06-17,IL,135046,1124143,1259189,6666
2020-06-18,IL,135639,1149054,1284693,6718
2020-06-19,IL,136470,1175533,1312003,6718
2020-06-20,IL,137104,1200864,1337968,6829
2020-06-21,IL,137762,1224022,1361784,6851
2020-06-22,IL,138224,1241779,1380003,6875
2020-06-23,IL,138825,1261685,1400510,6911
2020-06-24,IL,139540,1290301,1429841,6974
2020-06-25,IL,140434,1321093,1461527,7014
2020-06-26,IL,141344,1350661,1492005,7048
2020-06-27,IL,142130,1380112,1522242,7074
2020-06-28,IL,142776,1403255,1546031,7089
2020-06-29,IL,143514,1429435,1572949,7103
2020-06-30,IL,144238,1459780,1604018,7124
2020-07-01,IL,145066,1492042,1637108,7152
2020-07-02,IL,145935,1521435,1667370,7188
2020-07-03,IL,146872,1554885,1701757,7215
2020-07-04,IL,147734,1587859,1735593,7224
2020-07-05,IL,148373,1614455,1762828,7230
2020-07-06,IL,148987,1634975,1783962,7236
2020-07-07,IL,149574,1661382,1810956,7273
2020-07-08,IL,150554,1693144,1843698,7309
2020-07-09,IL,151572,1728306,1879878,7329
2020-07-10,IL,152899,1759976,1912875,7345
2020-07-11,IL,154094,1791126,1945220,7369
2020-07-12,IL,155048,1829066,1984114,7388
2020-07-13,IL,155931,1858195,2014126,7394
2020-07-14,IL,156638,1885934,2042572,7419
2020-07-15,IL,157825,1922908,2080733,7427
2020-07-16,IL,159082,1964657,2123739,7452
2020-07-17,IL,160509,2006965,2167474,7465
2020-07-18,IL,161785,2051788,2213573,7483
2020-07-19,IL,162750,2082936,2245686,7488
2020-07-20,IL,163923,2116361,2280284,7494
2020-07-21,IL,164878,2145151,2310029,7517
2020-07-22,IL,166476,2183186,2349662,7540
2020-07-23,IL,168100,2221268,2389368,7560
2020-07-24,IL,169699,2264066,2433765,7577
2020-07-25,IL,171125,2300840,2471965,7589
2020-03-06,IN,1,0,1,0
2020-03-07,IN,1,0,1,0
2020-03-08,IN,2,0,2,0
2020-03-09,IN,2,0,2,0
2020-03-10,IN,6,30,36,0
2020-03-11,IN,10,33,43,0
2020-03-12,IN,12,52,64,0
2020-03-13,IN,12,61,73,0
2020-03-14,IN,15,74,89,0
2020-03-15,IN,19,102,121,0
2020-03-16,IN,24,115,139,1
2020-03-17,IN,30,129,159,2
2020-03-18,IN,39,154,193,2
2020-03-19,IN,56,324,380,2
2020-03-20,IN,79,475,554,2
2020-03-21,IN,126,707,833,4
2020-03-22,IN,201,1293,1494,6
2020-03-23,IN,259,1701,1960,7
2020-03-24,IN,365,2566,2931,12
2020-03-25,IN,477,2879,3356,14
2020-03-26,IN,645,4006,4651,17
2020-03-27,IN,981,5955,6936,24
2020-03-28,IN,1232,7175,8407,31
2020-03-29,IN,1514,8316,9830,32
2020-03-30,IN,1786,9872,11658,35
2020-03-31,IN,2159,11214,13373,49
2020-04-01,IN,2565,11810,14375,65
2020-04-02,IN,3039,13246,16285,78
2020-04-03,IN,3437,14398,17835,102
2020-04-04,IN,3953,15847,19800,116
2020-04-05,IN,4411,18241,22652,127
2020-04-06,IN,4944,21247,26191,139
2020-04-07,IN,5507,23257,28764,173
2020-04-08,IN,5943,24926,30869,203
2020-04-09,IN,6351,25782,32133,245
2020-04-10,IN,6907,28133,35040,300
2020-04-11,IN,7435,31780,39215,330
2020-04-12,IN,7928,34561,42489,343
2020-04-13,IN,8236,36303,44539,350
2020-04-14,IN,8527,37490,46017,388
2020-04-15,IN,8955,39441,48396,436
2020-04-16,IN,9542,41573,51115,477
2020-04-17,IN,10154,44631,54785,519
2020-04-18,IN,10641,46232,56873,545
2020-04-19,IN,11210,49932,61142,562
2020-04-20,IN,11686,52953,64639,569
2020-04-21,IN,12097,55167,67264,630
2020-04-22,IN,12438,57032,69470,661
2020-04-23,IN,13039,59001,72040,706
2020-04-24,IN,13680,61873,75553,741
2020-04-25,IN,14395,65379,79774,785
2020-04-26,IN,15012,66696,81708,813
2020-04-27,IN,15961,68515,84476,844
2020-04-28,IN,16588,70593,87181,901
2020-04-29,IN,17182,74368,91550,1065
2020-04-30,IN,17835,77163,94998,1114
2020-05-01,IN,18630,81009,99639,1175
2020-05-02,IN,19295,84846,104141,1229
2020-05-03,IN,19933,88926,108859,1246
2020-05-04,IN,20507,92790,113297,1264
2020-05-05,IN,21033,94801,115834,1326
2020-05-06,IN,21870,98626,120496,1377
2020-05-07,IN,22503,102279,124782,1414
2020-05-08,IN,23146,106982,130128,1447
2020-05-09,IN,23732,111954,135686,1490
2020-05-10,IN,24126,115903,140029,1508
2020-05-11,IN,24627,122061,146688,1540
2020-05-12,IN,25127,125383,150510,1578
2020-05-13,IN,25473,128610,154083,1619
2020-05-14,IN,26053,134186,160239,1646
2020-05-15,IN,26655,138793,165448,1691
2020-05-16,IN,27280,144078,171358,1741
2020-05-17,IN,27778,149465,177243,1751
2020-05-18,IN,28255,155657,183912,1765
2020-05-19,IN,28705,160625,189330,1824
2020-05-20,IN,29274,166464,195738,1864
2020-05-21,IN,29936,173059,202995,1913
2020-05-22,IN,30409,178152,208561,1941
2020-05-23,IN,30901,184032,214933,1943
2020-05-24,IN,31376,189425,220801,1976
2020-05-25,IN,31715,194536,226251,1976
2020-05-26,IN,32078,198671,230749,2004
2020-05-27,IN,32437,202896,235333,2030
2020-05-28,IN,33068,209219,242287,2068
2020-05-29,IN,33558,215155,248713,2110
2020-05-30,IN,34211,222184,256395,2125
2020-05-31,IN,34574,226972,261546,2134
2020-06-01,IN,34830,231066,265896,2142
2020-06-02,IN,35237,236682,271919,2197
2020-06-03,IN,35712,242103,277815,2207
2020-06-04,IN,36096,249138,285234,2231
2020-06-05,IN,36578,255060,291638,2258
2020-06-06,IN,36997,260533,297530,2292
2020-06-07,IN,37397,266866,304263,2303
2020-06-08,IN,37623,271880,309503,2316
2020-06-09,IN,38033,277357,315390,2339
2020-06-10,IN,38337,281757,320094,2355
2020-06-11,IN,38748,288594,327342,2380
2020-06-12,IN,39146,296034,335180,2396
2020-06-13,IN,39543,301094,340637,2413
2020-06-14,IN,39909,308482,348391,2422
2020-06-15,IN,40430,315399,355829,2433
2020-06-16,IN,40786,322959,363745,2447
2020-06-17,IN,41013,330169,371182,2475
2020-06-18,IN,41438,343284,384722,2491
2020-06-19,IN,41746,351141,392887,2516
2020-06-20,IN,42061,359741,401802,2536
2020-06-21,IN,42423,369497,411920,2540
2020-06-22,IN,42633,376283,418916,2553
2020-06-23,IN,42871,383505,426376,2569
2020-06-24,IN,43140,388743,431883,2578
2020-06-25,IN,43655,400597,444252,2586
2020-06-26,IN,44140,409750,453890,2595
2020-06-27,IN,44575,418442,463017,2616
2020-06-28,IN,44930,425605,470535,2619
2020-06-29,IN,45228,431291,476519,2624
2020-06-30,IN,45594,438602,484196,2640
2020-07-01,IN,45952,443764,489716,2650
2020-07-02,IN,46387,450448,496835,2662
2020-07-03,IN,46915,457238,504153,2681
2020-07-04,IN,47432,464856,512288,2687
2020-07-05,IN,48008,473714,521722,2693
2020-07-06,IN,48331,478261,526592,2698
2020-07-07,IN,48626,481449,530075,2717
2020-07-08,IN,49063,486794,535857,2732
2020-07-09,IN,49575,492717,542292,2739
2020-07-10,IN,50300,500262,550562,2748
2020-07-11,IN,51079,507067,558146,2756
2020-07-12,IN,51612,513035,564647,2760
2020-07-13,IN,52037,518372,570409,2762
2020-07-14,IN,52685,525724,578409,2775
2020-07-15,IN,53370,533219,586589,2785
2020-07-16,IN,54080,541478,595558,2795
2020-07-17,IN,54813,549822,604635,2803
2020-07-18,IN,55654,558801,614455,2820
2020-07-19,IN,56571,570309,626880,2822
2020-07-20,IN,57206,578454,635660,2825
2020-07-21,IN,57916,586889,644805,2846
2020-07-22,IN,58673,595740,654413,2863
2020-07-23,IN,59602,606681,666283,2880
2020-07-24,IN,60598,618151,678749,2884
2020-07-25,IN,61520,628754,690274,2895
2020-03-06,KS,0,4,4,0
2020-03-07,KS,0,11,11,0
2020-03-08,KS,1,11,12,0
2020-03-09,KS,1,11,12,0
2020-03-10,KS,1,17,18,0
2020-03-11,KS,1,41,42,0
2020-03-12,KS,4,41,45,0
2020-03-13,KS,6,93,99,0
2020-03-14,KS,6,93,99,1
2020-03-15,KS,8,135,143,1
2020-03-16,KS,11,166,177,1
2020-03-17,KS,15,382,397,1
2020-03-18,KS,16,417,433,1
2020-03-19,KS,34,417,451,1
2020-03-20,KS,44,417,461,1
2020-03-21,KS,55,417,472,2
2020-03-22,KS,64,417,481,2
2020-03-23,KS,82,417,499,2
2020-03-24,KS,98,2086,2184,2
2020-03-25,KS,126,2360,2486,3
2020-03-26,KS,168,2869,3037,3
2020-03-27,KS,202,3229,3431,4
2020-03-28,KS,261,3671,3932,5
2020-03-29,KS,319,4194,4513,6
2020-03-30,KS,368,4554,4922,8
2020-03-31,KS,428,4996,5424,9
2020-04-01,KS,482,5411,5893,10
2020-04-02,KS,552,6059,6611,13
2020-04-03,KS,620,6454,7074,17
2020-04-04,KS,698,6880,7578,21
2020-04-05,KS,747,7476,8223,22
2020-04-06,KS,845,8239,9084,25
2020-04-07,KS,900,8614,9514,27
2020-04-08,KS,1046,9137,10183,38
2020-04-09,KS,1106,9669,10775,42
2020-04-10,KS,1166,10248,11414,50
2020-04-11,KS,1268,11075,12343,55
2020-04-12,KS,1337,11916,13253,56
2020-04-13,KS,1376,12488,13864,62
2020-04-14,KS,1426,12721,14147,69
2020-04-15,KS,1494,13174,14668,76
2020-04-16,KS,1588,14534,16122,80
2020-04-17,KS,1705,15196,16901,84
2020-04-18,KS,1790,15886,17676,86
2020-04-19,KS,1849,16281,18130,92
2020-04-20,KS,1986,16775,18761,100
2020-04-21,KS,2025,17076,19101,107
2020-04-22,KS,2211,17992,20203,110
2020-04-23,KS,2482,18836,21318,112
2020-04-24,KS,2777,20811,23588,111
2020-04-25,KS,3056,22143,25199,117
2020-04-26,KS,3174,23053,26227,118
2020-04-27,KS,3328,23839,27167,120
2020-04-28,KS,3491,24599,28090,124
2020-04-29,KS,3738,25720,29458,125
2020-04-30,KS,4238,27388,31626,129
2020-05-01,KS,4449,28585,33034,130
2020-05-02,KS,4746,30196,34942,131
2020-05-03,KS,5030,31748,36778,134
2020-05-04,KS,5245,33358,38603,136
2020-05-05,KS,5458,34634,40092,137
2020-05-06,KS,5734,36380,42114,144
2020-05-07,KS,6144,38678,44822,147
2020-05-08,KS,6501,41207,47708,152
2020-05-09,KS,6751,43182,49933,157
2020-05-10,KS,6948,45557,52505,157
2020-05-11,KS,7116,46993,54109,158
2020-05-12,KS,7116,46993,54109,158
2020-05-13,KS,7468,50160,57628,164
2020-05-14,KS,7468,50160,57628,164
2020-05-15,KS,7886,53706,61592,172
2020-05-16,KS,7886,53706,61592,172
2020-05-17,KS,7886,53706,61592,172
2020-05-18,KS,8340,58650,66990,173
2020-05-19,KS,8340,58650,66990,173
2020-05-20,KS,8539,62664,71203,178
2020-05-21,KS,8539,62664,71203,178
2020-05-22,KS,8958,67476,76434,185
2020-05-23,KS,8958,67476,76434,185
2020-05-24,KS,8958,67476,76434,185
2020-05-25,KS,9218,72181,81399,188
2020-05-26,KS,9218,72181,81399,188
2020-05-27,KS,9337,75151,84488,205
2020-05-28,KS,9337,75151,84488,205
2020-05-29,KS,9719,85230,94949,208
2020-05-30,KS,9719,85230,94949,208
2020-05-31,KS,9719,85230,94949,208
2020-06-01,KS,10011,85230,95241,217
2020-06-02,KS,10011,93301,103312,217
2020-06-03,KS,10170,97883,108053,222
2020-06-04,KS,10170,97883,108053,222
2020-06-05,KS,10393,103260,113653,232
2020-06-06,KS,10393,103260,113653,232
2020-06-07,KS,10393,103260,113653,232
2020-06-08,KS,10650,108859,119509,236
2020-06-09,KS,10650,108859,119509,236
2020-06-10,KS,10812,112930,123742,240
2020-06-11,KS,10812,112930,123742,240
2020-06-12,KS,11047,118105,129152,243
2020-06-13,KS,11047,118105,129152,243
2020-06-14,KS,11047,118105,129152,243
2020-06-15,KS,11419,125543,136962,245
2020-06-16,KS,11419,125543,136962,245
2020-06-17,KS,11681,130443,142124,247
2020-06-18,KS,11681,130443,142124,247
2020-06-19,KS,12059,135590,147649,254
2020-06-20,KS,12059,135590,147649,254
2020-06-21,KS,12059,135590,147649,254
2020-06-22,KS,12465,142548,155013,259
2020-06-23,KS,12465,142548,155013,259
2020-06-24,KS,12970,148735,161705,261
2020-06-25,KS,12970,148735,161705,261
2020-06-26,KS,13538,154321,167859,264
2020-06-27,KS,13538,154321,167859,264
2020-06-28,KS,13538,154321,167859,264
2020-06-29,KS,14443,162282,176725,270
2020-06-30,KS,14443,162282,176725,270
2020-07-01,KS,14990,168183,183173,272
2020-07-02,KS,14990,168183,183173,272
2020-07-03,KS,15919,175642,191561,277
2020-07-04,KS,15919,175642,191561,277
2020-07-05,KS,15919,175642,191561,277
2020-07-06,KS,16901,185318,202219,280
2020-07-07,KS,16901,185318,202219,280
2020-07-08,KS,17618,190864,208482,282
2020-07-09,KS,17618,190864,208482,282
2020-07-10,KS,18611,199168,217779,284
2020-07-11,KS,18611,199168,217779,284
2020-07-12,KS,18611,199168,217779,284
2020-07-13,KS,20058,211117,231175,288
2020-07-14,KS,20058,211117,231175,288
2020-07-15,KS,20933,218441,239374,299
2020-07-16,KS,20933,218441,239374,299
2020-07-17,KS,21965,227388,249353,299
2020-07-18,KS,21965,227388,249353,299
2020-07-19,KS,21965,227388,249353,299
2020-07-20,KS,23334,238197,261531,307
2020-07-21,KS,23334,238197,261531,307
2020-07-22,KS,24104,244582,268686,308
2020-07-23,KS,24104,244582,268686,308
2020-07-24,KS,25109,252858,277967,326
2020-07-25,KS,25109,252858,277967,326
2020-03-06,KY,0,7,7,0
2020-03-07,KY,1,9,10,0
2020-03-08,KY,1,13,14,0
2020-03-09,KY,4,17,21,0
2020-03-10,KY,6,28,34,0
2020-03-11,KY,8,46,54,0
2020-03-12,KY,8,56,64,0
2020-03-13,KY,11,107,118,0
2020-03-14,KY,14,139,153,1
2020-03-15,KY,16,139,155,1
2020-03-16,KY,21,234,255,1
2020-03-17,KY,22,295,317,1
2020-03-18,KY,26,354,380,1
2020-03-19,KY,35,454,489,1
2020-03-20,KY,47,592,639,1
2020-03-21,KY,54,714,768,2
2020-03-22,KY,99,1472,1571,3
2020-03-23,KY,104,1762,1866,3
2020-03-24,KY,124,1762,1886,4
2020-03-25,KY,157,2865,3022,4
2020-03-26,KY,198,3102,3300,4
2020-03-27,KY,248,3768,4016,6
2020-03-28,KY,302,4821,5123,8
2020-03-29,KY,394,5147,5541,9
2020-03-30,KY,439,5579,6018,9
2020-03-31,KY,480,6330,6810,11
2020-04-01,KY,591,6965,7556,17
2020-04-02,KY,680,7220,7900,20
2020-04-03,KY,770,12034,12804,31
2020-04-04,KY,831,14741,15572,37
2020-04-05,KY,917,15746,16663,40
2020-04-06,KY,955,17812,18767,45
2020-04-07,KY,1008,18947,19955,59
2020-04-08,KY,1149,20455,21604,65
2020-04-09,KY,1346,20455,21801,73
2020-04-10,KY,1693,22595,24288,90
2020-04-11,KY,1693,22595,24288,90
2020-04-12,KY,1840,22727,24567,94
2020-04-13,KY,1963,23903,25866,97
2020-04-14,KY,2048,24635,26683,104
2020-04-15,KY,2210,25487,27697,115
2020-04-16,KY,2291,26033,28324,122
2020-04-17,KY,2429,27318,29747,129
2020-04-18,KY,2522,28074,30596,137
2020-04-19,KY,2707,29518,32225,144
2020-04-20,KY,2960,29612,32572,148
2020-04-21,KY,3050,29770,32820,154
2020-04-22,KY,3192,30136,33328,171
2020-04-23,KY,3373,32702,36075,185
2020-04-24,KY,3481,39363,42844,191
2020-04-25,KY,3779,41183,44962,200
2020-04-26,KY,3905,42653,46558,205
2020-04-27,KY,4074,44400,48474,208
2020-04-28,KY,4146,44653,48799,213
2020-04-29,KY,4375,48036,52411,225
2020-04-30,KY,4539,49562,54101,235
2020-05-01,KY,4708,51904,56612,240
2020-05-02,KY,4879,52770,57649,248
2020-05-03,KY,4879,52770,57649,248
2020-05-04,KY,5130,53279,58409,253
2020-05-05,KY,5245,54802,60047,261
2020-05-06,KY,5822,55192,61014,275
2020-05-07,KY,5934,72672,78606,283
2020-05-08,KY,6129,75272,81401,294
2020-05-09,KY,6288,80159,86447,298
2020-05-10,KY,6440,80483,86923,304
2020-05-11,KY,6440,80483,86923,304
2020-05-12,KY,6677,97347,104024,311
2020-05-13,KY,6853,103781,110634,321
2020-05-14,KY,7080,110315,117395,326
2020-05-15,KY,7225,114053,121278,328
2020-05-16,KY,7444,120290,127734,332
2020-05-17,KY,7688,121997,129685,334
2020-05-18,KY,7688,121997,129685,334
2020-05-19,KY,8069,145917,153986,366
2020-05-20,KY,8069,145917,153986,366
2020-05-21,KY,8167,150505,158672,376
2020-05-22,KY,8286,157954,166240,386
2020-05-23,KY,8426,163033,171459,391
2020-05-24,KY,8571,161285,169856,391
2020-05-25,KY,8571,161285,169856,391
2020-05-26,KY,8571,161285,169856,391
2020-05-27,KY,9077,173024,182101,400
2020-05-28,KY,9077,173024,182101,400
2020-05-29,KY,9184,212090,221274,409
2020-05-30,KY,9464,198731,208195,418
2020-05-31,KY,9704,204049,213753,431
2020-06-01,KY,10046,206000,216046,439
2020-06-02,KY,10185,217086,227271,442
2020-06-03,KY,10410,221789,232199,450
2020-06-04,KY,10705,225220,235925,458
2020-06-05,KY,10977,231440,242417,466
2020-06-06,KY,11287,237775,249062,470
2020-06-07,KY,11287,237775,249062,470
2020-06-08,KY,11476,241381,252857,472
2020-06-09,KY,11708,248230,259938,477
2020-06-10,KY,11883,262531,274414,484
2020-06-11,KY,11945,269149,281094,493
2020-06-12,KY,11945,269149,281094,493
2020-06-13,KY,12445,282140,294585,499
2020-06-14,KY,12445,282140,294585,499
2020-06-15,KY,12647,283204,295851,505
2020-06-16,KY,12829,283204,296033,512
2020-06-17,KY,12995,286874,299869,518
2020-06-18,KY,13197,293183,306380,520
2020-06-19,KY,13454,297773,311227,522
2020-06-20,KY,13630,303531,317161,524
2020-06-21,KY,13750,303531,317281,526
2020-06-22,KY,13839,308193,322032,526
2020-06-23,KY,14141,317153,331294,537
2020-06-24,KY,14363,321339,335702,538
2020-06-25,KY,14617,328265,342882,546
2020-06-26,KY,14859,335895,350754,553
2020-06-27,KY,14859,335895,350754,553
2020-06-28,KY,15232,343259,358491,558
2020-06-29,KY,15347,346094,361441,560
2020-06-30,KY,15624,355310,370934,565
2020-07-01,KY,15842,361248,377090,572
2020-07-02,KY,16079,369715,385794,581
2020-07-03,KY,16376,379271,395647,585
2020-07-04,KY,16376,379271,395647,585
2020-07-05,KY,16376,379271,395647,585
2020-07-06,KY,17152,383190,400342,593
2020-07-07,KY,17519,392353,409872,602
2020-07-08,KY,17919,398002,415921,608
2020-07-09,KY,18245,405768,424013,612
2020-07-10,KY,18670,414020,432690,620
2020-07-11,KY,19121,418781,437902,622
2020-07-12,KY,19389,418781,438170,625
2020-07-13,KY,19653,422232,441885,629
2020-07-14,KY,20223,435333,455556,635
2020-07-15,KY,20677,438510,459187,645
2020-07-16,KY,21083,446921,468004,650
2020-07-17,KY,21605,461457,483062,658
2020-07-18,KY,22184,468017,490201,667
2020-07-19,KY,23161,469563,492724,670
2020-07-20,KY,23414,470740,494154,671
2020-07-21,KY,24060,484633,508693,674
2020-07-22,KY,24540,494535,519075,677
2020-07-23,KY,25147,499648,524795,684
2020-07-24,KY,25931,507545,533476,691
2020-07-25,KY,26764,514819,541583,696
2020-03-07,LA,0,0,0,0
2020-03-08,LA,0,5,5,0
2020-03-09,LA,1,5,6,0
2020-03-10,LA,1,11,12,0
2020-03-11,LA,6,37,43,0
2020-03-12,LA,14,37,51,0
2020-03-13,LA,36,37,73,0
2020-03-14,LA,51,109,160,0
2020-03-15,LA,90,156,246,2
2020-03-16,LA,115,188,303,2
2020-03-17,LA,137,286,423,4
2020-03-18,LA,240,335,575,6
2020-03-19,LA,347,458,805,8
2020-03-20,LA,473,568,1041,12
2020-03-21,LA,580,2180,2760,16
2020-03-22,LA,837,2661,3498,20
2020-03-23,LA,1172,4776,5948,34
2020-03-24,LA,1388,7215,8603,46
2020-03-25,LA,1795,9656,11451,65
2020-03-26,LA,2305,15724,18029,83
2020-03-27,LA,2746,18613,21359,119
2020-03-28,LA,3315,21846,25161,137
2020-03-29,LA,3540,24331,27871,151
2020-03-30,LA,4025,30008,34033,185
2020-03-31,LA,5237,33730,38967,239
2020-04-01,LA,6424,39352,45776,273
2020-04-02,LA,9150,41936,51086,310
2020-04-03,LA,10297,43348,53645,370
2020-04-04,LA,12496,46002,58498,409
2020-04-05,LA,13010,47315,60325,477
2020-04-06,LA,14867,54299,69166,512
2020-04-07,LA,16284,58371,74655,582
2020-04-08,LA,17030,64376,81406,652
2020-04-09,LA,18283,68636,86919,702
2020-04-10,LA,19253,73027,92280,755
2020-04-11,LA,20014,76901,96915,806
2020-04-12,LA,20595,83450,104045,840
2020-04-13,LA,21016,87075,108091,884
2020-04-14,LA,21518,96904,118422,1013
2020-04-15,LA,21951,99977,121928,1103
2020-04-16,LA,22532,104054,126586,1156
2020-04-17,LA,23118,108869,131987,1213
2020-04-18,LA,23580,114419,137999,1267
2020-04-19,LA,23928,111420,135348,1296
2020-04-20,LA,24523,111588,136111,1328
2020-04-21,LA,24854,111588,136442,1405
2020-04-22,LA,25258,111588,136846,1473
2020-04-23,LA,25739,111774,137513,1540
2020-04-24,LA,26140,111972,138112,1601
2020-04-25,LA,26512,112490,139002,1644
2020-04-26,LA,26773,116263,143036,1670
2020-04-27,LA,27068,119921,146989,1697
2020-04-28,LA,27286,123822,151108,1758
2020-04-29,LA,27660,128908,156568,1802
2020-04-30,LA,28001,133308,161309,1862
2020-05-01,LA,28711,139540,168251,1927
2020-05-02,LA,29140,143718,172858,1950
2020-05-03,LA,29340,146820,176160,1969
2020-05-04,LA,29673,151258,180931,2064
2020-05-05,LA,29996,158235,188231,2115
2020-05-06,LA,30399,164273,194672,2115
2020-05-07,LA,30652,170115,200767,2208
2020-05-08,LA,30855,171561,202416,2227
2020-05-09,LA,31417,180740,212157,2267
2020-05-10,LA,31600,184272,215872,2286
2020-05-11,LA,31815,189015,220830,2308
2020-05-12,LA,32050,195962,228012,2347
2020-05-13,LA,32662,205242,237904,2381
2020-05-14,LA,33489,214099,247588,2417
2020-05-15,LA,33837,219352,253189,2448
2020-05-16,LA,34117,225625,259742,2479
2020-05-17,LA,34432,230738,265170,2491
2020-05-18,LA,34709,235039,269748,2563
2020-05-19,LA,35038,243035,278073,2581
2020-05-20,LA,35316,250654,285970,2608
2020-05-21,LA,36504,268877,305381,2629
2020-05-22,LA,36925,274883,311808,2668
2020-05-23,LA,37040,277407,314447,2668
2020-05-24,LA,37169,278867,316036,2690
2020-05-25,LA,37809,293089,330898,2690
2020-05-26,LA,38054,302972,341026,2701
2020-05-27,LA,38497,309150,347647,2722
2020-05-28,LA,38802,316225,355027,2740
2020-05-29,LA,38802,316225,355027,2766
2020-05-30,LA,39577,329242,368819,2785
2020-05-31,LA,39916,335193,375109,2791
2020-06-01,LA,40341,347029,387370,2801
2020-06-02,LA,40746,352387,393133,2835
2020-06-03,LA,41133,360954,402087,2870
2020-06-04,LA,41562,369624,411186,2883
2020-06-05,LA,41989,378797,420786,2912
2020-06-06,LA,42486,385583,428069,2925
2020-06-07,LA,42816,391249,434065,2936
2020-06-08,LA,43050,399552,442602,2944
2020-06-09,LA,43612,410056,453668,2957
2020-06-10,LA,44030,416090,460120,2968
2020-06-11,LA,44472,425201,469673,2987
2020-06-12,LA,44995,434539,479534,2996
2020-06-13,LA,46283,458100,504383,3004
2020-06-14,LA,46619,462713,509332,3014
2020-06-15,LA,47172,471553,518725,3018
2020-06-16,LA,47706,485011,532717,3042
2020-06-17,LA,48634,496587,545221,3062
2020-06-18,LA,48634,496587,545221,3062
2020-06-19,LA,48515,542394,590909,3084
2020-06-20,LA,49385,555431,604816,3104
2020-06-21,LA,49778,561034,610812,3105
2020-06-22,LA,50239,567825,618064,3117
2020-06-23,LA,51595,584344,635939,3134
2020-06-24,LA,52477,596028,648505,3152
2020-06-25,LA,53415,607250,660665,3164
2020-06-26,LA,54769,623237,678006,3190
2020-06-27,LA,54769,623237,678006,3190
2020-06-28,LA,56236,639875,696111,3199
2020-06-29,LA,57081,647556,704637,3199
2020-06-30,LA,58095,670416,728511,3221
2020-07-01,LA,60178,691910,752088,3238
2020-07-02,LA,61561,705813,767374,3255
2020-07-03,LA,63289,720853,784142,3278
2020-07-04,LA,63289,720853,784142,3278
2020-07-05,LA,65226,737228,802454,3288
2020-07-06,LA,66327,747318,813645,3296
2020-07-07,LA,68263,779335,847598,3319
2020-07-08,LA,70151,795586,865737,3339
2020-07-09,LA,71994,808146,880140,3355
2020-07-10,LA,74636,830612,905248,3380
2020-07-11,LA,76803,847644,924447,3403
2020-07-12,LA,78122,856873,934995,3416
2020-07-13,LA,79827,873599,953426,3423
2020-07-14,LA,82042,894413,976455,3445
2020-07-15,LA,84131,917069,1001200,3461
2020-07-16,LA,86411,937726,1024137,3485
2020-07-17,LA,88590,955350,1043940,3509
2020-07-18,LA,88590,955350,1043940,3509
2020-07-19,LA,91706,977598,1069304,3543
2020-07-20,LA,94892,1008032,1102924,3572
2020-07-21,LA,96583,1026379,1122962,3608
2020-07-22,LA,99354,1053547,1152901,3670
2020-07-23,LA,101650,1073218,1174868,3686
2020-07-24,LA,103734,1095992,1199726,3715
2020-07-25,LA,103734,1095992,1199726,3715
2020-03-12,MA,8,0,8,0
2020-03-13,MA,23,0,23,0
2020-03-14,MA,38,0,38,0
2020-03-15,MA,64,584,648,0
2020-03-16,MA,97,1199,1296,0
2020-03-17,MA,118,1633,1751,0
2020-03-18,MA,156,2115,2271,2
2020-03-19,MA,229,2918,3147,3
2020-03-20,MA,314,3795,4109,5
2020-03-21,MA,426,4799,5225,7
2020-03-22,MA,547,5476,6023,11
2020-03-23,MA,678,8263,8941,17
2020-03-24,MA,1060,12714,13774,26
2020-03-25,MA,1739,18079,19818,33
2020-03-26,MA,2318,21327,23645,42
2020-03-27,MA,3151,26244,29395,57
2020-03-28,MA,4158,30915,35073,72
2020-03-29,MA,4856,34234,39090,99
2020-03-30,MA,5653,37166,42819,124
2020-03-31,MA,6521,40440,46961,153
2020-04-01,MA,7639,44125,51764,187
2020-04-02,MA,8867,47767,56634,229
2020-04-03,MA,10303,52685,62988,265
2020-04-04,MA,11637,57191,68828,304
2020-04-05,MA,12402,59565,71967,370
2020-04-06,MA,13739,62720,76459,448
2020-04-07,MA,15104,66270,81374,515
2020-04-08,MA,16692,70849,87541,615
2020-04-09,MA,18843,76146,94989,725
2020-04-10,MA,20878,81564,102442,832
2020-04-11,MA,22766,86115,108881,946
2020-04-12,MA,25381,91463,116844,1056
2020-04-13,MA,26794,95500,122294,1211
2020-04-14,MA,28109,98820,126929,1329
2020-04-15,MA,29970,102790,132760,1502
2020-04-16,MA,32492,110098,142590,1667
2020-04-17,MA,35125,117195,152320,1822
2020-04-18,MA,37527,124604,162131,1983
2020-04-19,MA,39820,129295,169115,2146
2020-04-20,MA,41416,136046,177462,2303
2020-04-21,MA,43168,141444,184612,2449
2020-04-22,MA,44913,144789,189702,2597
2020-04-23,MA,47992,156324,204316,2769
2020-04-24,MA,50969,164244,215213,2877
2020-04-25,MA,53348,173497,226845,2877
2020-04-26,MA,54938,181162,236100,2899
2020-04-27,MA,56462,188425,244887,3003
2020-04-28,MA,58302,196198,254500,3153
2020-04-29,MA,60265,205353,265618,3405
2020-04-30,MA,62205,213442,275647,3562
2020-05-01,MA,64311,225325,289636,3716
2020-05-02,MA,66263,232731,298994,3846
2020-05-03,MA,68087,246559,314646,4004
2020-05-04,MA,69087,255181,324268,4090
2020-05-05,MA,70271,263078,333349,4212
2020-05-06,MA,72025,267614,339639,4420
2020-05-07,MA,73721,277911,351632,4552
2020-05-08,MA,75333,290690,366023,4702
2020-05-09,MA,76743,299794,376537,4840
2020-05-10,MA,77793,310596,388389,4979
2020-05-11,MA,78462,316266,394728,5108
2020-05-12,MA,79332,322164,401496,5141
2020-05-13,MA,80497,329535,410032,5315
2020-05-14,MA,82182,342179,424361,5482
2020-05-15,MA,83421,352258,435679,5592
2020-05-16,MA,84933,363156,448089,5705
2020-05-17,MA,86010,374816,460826,5797
2020-05-18,MA,87052,382147,469199,5862
2020-05-19,MA,87925,389015,476940,5938
2020-05-20,MA,88970,400983,489953,6066
2020-05-21,MA,90084,411402,501486,6148
2020-05-22,MA,90889,420755,511644,6228
2020-05-23,MA,91662,429324,520986,6304
2020-05-24,MA,92675,439698,532373,6372
2020-05-25,MA,93271,447290,540561,6416
2020-05-26,MA,93693,451788,545481,6473
2020-05-27,MA,94220,457924,552144,6547
2020-05-28,MA,94895,467428,562323,6640
2020-05-29,MA,95512,476233,571745,6718
2020-05-30,MA,96301,486218,582519,6768
2020-05-31,MA,96965,495888,592853,6846
2020-06-01,MA,100805,502628,603433,7035
2020-06-02,MA,101163,508232,609395,7085
2020-06-03,MA,101592,516169,617761,7152
2020-06-04,MA,102063,522872,624935,7201
2020-06-05,MA,102557,532212,634769,7235
2020-06-06,MA,103132,541507,644639,7289
2020-06-07,MA,103436,549054,652490,7316
2020-06-08,MA,103626,553643,657269,7353
2020-06-09,MA,103889,558103,661992,7408
2020-06-10,MA,104156,567934,672090,7454
2020-06-11,MA,104667,578421,683088,7492
2020-06-12,MA,105059,588300,693359,7538
2020-06-13,MA,105395,598201,703596,7576
2020-06-14,MA,105603,607107,712710,7624
2020-06-15,MA,105690,611541,717231,7647
2020-06-16,MA,105885,617762,723647,7665
2020-06-17,MA,106151,625895,732046,7734
2020-06-18,MA,106422,634838,741260,7770
2020-06-19,MA,106650,644157,750807,7800
2020-06-20,MA,106936,658001,764937,7828
2020-06-21,MA,107061,666259,773320,7858
2020-06-22,MA,107210,672853,780063,7874
2020-06-23,MA,107439,680203,787642,7890
2020-06-24,MA,107611,687461,795072,7938
2020-06-25,MA,107837,697619,805456,7963
2020-06-26,MA,108070,706015,814085,8013
2020-06-27,MA,108443,717899,826342,8041
2020-06-28,MA,108667,727127,835794,8060
2020-06-29,MA,108768,733519,842287,8095
2020-06-30,MA,108882,739259,848141,8054
2020-07-01,MA,109143,749292,858435,8081
2020-07-02,MA,109338,756920,866258,8132
2020-07-03,MA,109628,768152,877780,8149
2020-07-04,MA,109838,775929,885767,8172
2020-07-05,MA,109974,781711,891685,8183
2020-07-06,MA,110137,789280,899417,8198
2020-07-07,MA,110338,796422,906760,8213
2020-07-08,MA,110602,805393,915995,8243
2020-07-09,MA,110897,814864,925761,8268
2020-07-10,MA,111110,827506,938616,8296
2020-07-11,MA,111398,834936,946334,8310
2020-07-12,MA,111597,845883,957480,8325
2020-07-13,MA,111827,854316,966143,8330
2020-07-14,MA,112130,866084,978214,8340
2020-07-15,MA,112347,876366,988713,8368
2020-07-16,MA,112581,889103,1001684,8380
2020-07-17,MA,112879,901708,1014587,8402
2020-07-18,MA,113238,913595,1026833,8419
2020-07-19,MA,113534,927001,1040535,8431
2020-07-20,MA,113789,937492,1051281,8433
2020-07-21,MA,114033,945148,1059181,8450
2020-07-22,MA,114320,955742,1070062,8468
2020-07-23,MA,114320,955742,1070062,8468
2020-07-24,MA,114647,971605,1086252,8484
2020-07-25,MA,115268,995615,1110883,8510
2020-03-05,MD,0,17,17,0
2020-03-06,MD,3,26,29,0
2020-03-07,MD,3,41,44,0
2020-03-08,MD,3,52,55,0
2020-03-09,MD,5,73,78,0
2020-03-10,MD,6,89,95,0
2020-03-11,MD,9,94,103,0
2020-03-12,MD,12,94,106,0
2020-03-13,MD,17,94,111,0
2020-03-14,MD,26,94,120,0
2020-03-15,MD,31,94,125,0
2020-03-16,MD,37,94,131,2
2020-03-17,MD,57,94,151,0
2020-03-18,MD,85,94,179,2
2020-03-19,MD,107,94,201,2
2020-03-20,MD,149,94,243,3
2020-03-21,MD,190,94,284,3
2020-03-22,MD,244,94,338,4
2020-03-23,MD,288,94,382,4
2020-03-24,MD,349,94,443,5
2020-03-25,MD,423,94,517,5
2020-03-26,MD,580,94,674,7
2020-03-27,MD,774,94,868,10
2020-03-28,MD,992,11516,12508,17
2020-03-29,MD,1239,12354,13593,24
2020-03-30,MD,1413,13316,14729,35
2020-03-31,MD,1660,14868,16528,43
2020-04-01,MD,1985,17233,19218,52
2020-04-02,MD,2331,18890,21221,64
2020-04-03,MD,2758,20932,23690,84
2020-04-04,MD,3125,22485,25610,101
2020-04-05,MD,3609,24728,28337,122
2020-04-06,MD,4045,25572,29617,138
2020-04-07,MD,4371,27256,31627,160
2020-04-08,MD,5529,32933,38462,191
2020-04-09,MD,6185,35344,41529,221
2020-04-10,MD,6968,37480,44448,255
2020-04-11,MD,7694,39544,47238,298
2020-04-12,MD,8225,41539,49764,335
2020-04-13,MD,8936,42815,51751,384
2020-04-14,MD,9472,44261,53733,421
2020-04-15,MD,10032,45731,55763,469
2020-04-16,MD,10784,48059,58843,499
2020-04-17,MD,11572,50437,62009,541
2020-04-18,MD,12308,53062,65370,582
2020-04-19,MD,12830,55061,67891,626
2020-04-20,MD,13684,57713,71397,683
2020-04-21,MD,14193,59442,73635,732
2020-04-22,MD,14775,61754,76529,779
2020-04-23,MD,15737,64363,80100,831
2020-04-24,MD,16616,68100,84716,899
2020-04-25,MD,17766,71357,89123,948
2020-04-26,MD,18581,78084,96665,1001
2020-04-27,MD,19487,85489,104976,1045
2020-04-28,MD,20113,87672,107785,1099
2020-04-29,MD,20849,90080,110929,1168
2020-04-30,MD,21742,92617,114359,1226
2020-05-01,MD,23472,97511,120983,1276
2020-05-02,MD,24473,101049,125522,1323
2020-05-03,MD,25462,107332,132794,1372
2020-05-04,MD,26408,110587,136995,1424
2020-05-05,MD,27117,112986,140103,1476
2020-05-06,MD,28163,115849,144012,1520
2020-05-07,MD,29374,119226,148600,1580
2020-05-08,MD,30485,121702,152187,1643
2020-05-09,MD,31534,124494,156028,1692
2020-05-10,MD,32587,127344,159931,1739
2020-05-11,MD,33373,131407,164780,1788
2020-05-12,MD,34061,135442,169503,1834
2020-05-13,MD,34812,138762,173574,1881
2020-05-14,MD,35903,142551,178454,1935
2020-05-15,MD,36986,145840,182826,1991
2020-05-16,MD,37968,152207,190175,2040
2020-05-17,MD,38804,156122,194926,2090
2020-05-18,MD,39762,161744,201506,2122
2020-05-19,MD,41546,167112,208658,2164
2020-05-20,MD,42323,173007,215330,2198
2020-05-21,MD,43531,176702,220233,2221
2020-05-22,MD,44424,183478,227902,2274
2020-05-23,MD,45495,186832,232327,2306
2020-05-24,MD,46313,194049,240362,2341
2020-05-25,MD,47152,202425,249577,2379
2020-05-26,MD,47687,206800,254487,2417
2020-05-27,MD,48423,213632,262055,2458
2020-05-28,MD,49709,225149,274858,2501
2020-05-29,MD,50988,233530,284518,2538
2020-05-30,MD,52015,241931,293946,2562
2020-05-31,MD,52778,249103,301881,2596
2020-06-01,MD,53327,255403,308730,2625
2020-06-02,MD,54175,261640,315815,2646
2020-06-03,MD,54982,272643,327625,2666
2020-06-04,MD,55858,281160,337018,2668
2020-06-05,MD,56770,290956,347726,2702
2020-06-06,MD,57482,299894,357376,2740
2020-06-07,MD,57973,306830,364803,2749
2020-06-08,MD,58404,313099,371503,2776
2020-06-09,MD,58904,319178,378082,2811
2020-06-10,MD,59465,325177,384642,2844
2020-06-11,MD,60197,332173,392370,2875
2020-06-12,MD,60613,339482,400095,2900
2020-06-13,MD,61305,347453,408758,2926
2020-06-14,MD,61701,353608,415309,2939
2020-06-15,MD,62032,359076,421108,2947
2020-06-16,MD,62409,366816,429225,2982
2020-06-17,MD,62969,378374,441343,2996
2020-06-18,MD,63229,384379,447608,3016
2020-06-19,MD,63548,390121,453669,3030
2020-06-20,MD,63956,398324,462280,3052
2020-06-21,MD,64306,404725,469031,3066
2020-06-22,MD,64603,410122,474725,3074
2020-06-23,MD,65007,418528,483535,3092
2020-06-24,MD,65337,425120,490457,3108
2020-06-25,MD,65777,433182,498959,3129
2020-06-26,MD,66115,440282,506397,3142
2020-06-27,MD,66450,447366,513816,3157
2020-06-28,MD,66777,452696,519473,3168
2020-06-29,MD,67254,462059,529313,3175
2020-06-30,MD,67559,468296,535855,3190
2020-07-01,MD,67918,474686,542604,3205
2020-07-02,MD,68423,484752,553175,3212
2020-07-03,MD,68961,494873,563834,3223
2020-07-04,MD,69341,504001,573342,3236
2020-07-05,MD,69632,510330,579962,3243
2020-07-06,MD,69904,517457,587361,3246
2020-07-07,MD,70396,523982,594378,3266
2020-07-08,MD,70861,532247,603108,3275
2020-07-09,MD,71447,541134,612581,3288
2020-07-10,MD,71910,549153,621063,3303
2020-07-11,MD,72467,556810,629277,3310
2020-07-12,MD,73109,570282,643391,3319
2020-07-13,MD,73527,578430,651957,3325
2020-07-14,MD,74260,591809,666069,3334
2020-07-15,MD,75016,605072,680088,3341
2020-07-16,MD,75664,616865,692529,3347
2020-07-17,MD,76371,631845,708216,3359
2020-07-18,MD,77206,643780,720986,3368
2020-07-19,MD,78131,661654,739785,3377
2020-07-20,MD,78685,670594,749279,3382
2020-07-21,MD,79545,684822,764367,3402
2020-07-22,MD,80172,702661,782833,3405
2020-07-23,MD,80836,708205,789041,3409
2020-07-24,MD,81766,722584,804350,3422
2020-07-25,MD,83054,742272,825326,3433
2020-03-07,ME,0,1,1,0
2020-03-08,ME,0,1,1,0
2020-03-09,ME,0,1,1,0
2020-03-10,ME,0,20,20,0
2020-03-11,ME,0,42,42,0
2020-03-12,ME,1,65,66,0
2020-03-13,ME,3,91,94,0
2020-03-14,ME,3,91,94,0
2020-03-15,ME,3,91,94,0
2020-03-16,ME,17,764,781,0
2020-03-17,ME,32,1303,1335,0
2020-03-18,ME,43,1670,1713,0
2020-03-19,ME,53,2004,2057,0
2020-03-20,ME,57,2264,2321,0
2020-03-21,ME,73,2264,2337,0
2020-03-22,ME,89,2264,2353,0
2020-03-23,ME,107,2791,2898,0
2020-03-24,ME,125,3014,3139,0
2020-03-25,ME,149,3177,3326,0
2020-03-26,ME,155,3394,3549,0
2020-03-27,ME,168,3394,3562,1
2020-03-28,ME,211,3394,3605,1
2020-03-29,ME,253,3394,3647,3
2020-03-30,ME,275,3394,3669,3
2020-03-31,ME,303,6088,6391,5
2020-04-01,ME,344,6088,6432,7
2020-04-02,ME,376,6088,6464,7
2020-04-03,ME,432,6088,6520,9
2020-04-04,ME,456,6088,6544,10
2020-04-05,ME,470,6088,6558,10
2020-04-06,ME,499,6088,6587,10
2020-04-07,ME,519,6088,6607,12
2020-04-08,ME,537,6088,6625,14
2020-04-09,ME,560,6088,6648,16
2020-04-10,ME,586,6088,6674,17
2020-04-11,ME,616,6088,6704,19
2020-04-12,ME,633,6088,6721,19
2020-04-13,ME,698,11608,12306,19
2020-04-14,ME,734,11608,12342,20
2020-04-15,ME,770,14076,14846,24
2020-04-16,ME,796,14076,14872,27
2020-04-17,ME,827,14076,14903,29
2020-04-18,ME,847,14076,14923,32
2020-04-19,ME,867,14076,14943,34
2020-04-20,ME,875,14076,14951,35
2020-04-21,ME,888,14076,14964,36
2020-04-22,ME,907,16784,17691,39
2020-04-23,ME,937,16784,17721,44
2020-04-24,ME,965,16784,17749,47
2020-04-25,ME,990,16784,17774,50
2020-04-26,ME,1015,16784,17799,50
2020-04-27,ME,1023,16784,17807,51
2020-04-28,ME,1040,16784,17824,51
2020-04-29,ME,1056,19546,20602,52
2020-04-30,ME,1095,19546,20641,53
2020-05-01,ME,1123,19546,20669,55
2020-05-02,ME,1152,19546,20698,56
2020-05-03,ME,1185,19546,20731,57
2020-05-04,ME,1205,19546,20751,57
2020-05-05,ME,1226,19546,20772,61
2020-05-06,ME,1254,22092,23346,62
2020-05-07,ME,1330,22092,23422,62
2020-05-08,ME,1374,22092,23466,63
2020-05-09,ME,1408,22092,23500,64
2020-05-10,ME,1436,22092,23528,64
2020-05-11,ME,1462,22092,23554,65
2020-05-12,ME,1477,22092,23569,65
2020-05-13,ME,1515,22092,23607,66
2020-05-14,ME,1565,22092,23657,69
2020-05-15,ME,1603,22092,23695,69
2020-05-16,ME,1648,22092,23740,70
2020-05-17,ME,1687,22092,23779,70
2020-05-18,ME,1713,22092,23805,71
2020-05-19,ME,1741,22092,23833,73
2020-05-20,ME,1819,35450,37269,73
2020-05-21,ME,1877,35450,37327,73
2020-05-22,ME,1948,35450,37398,75
2020-05-23,ME,2013,35450,37463,77
2020-05-24,ME,2055,35450,37505,78
2020-05-25,ME,2074,35450,37524,78
2020-05-26,ME,2109,35450,37559,79
2020-05-27,ME,2137,43480,45617,81
2020-05-28,ME,2189,43480,45669,84
2020-05-29,ME,2226,43480,45706,85
2020-05-30,ME,2282,47284,49566,89
2020-05-31,ME,2325,47284,49609,89
2020-06-01,ME,2349,47284,49633,89
2020-06-02,ME,2377,50591,52968,94
2020-06-03,ME,2418,50591,53009,95
2020-06-04,ME,2446,53755,56201,95
2020-06-05,ME,2482,55050,57532,98
2020-06-06,ME,2524,56399,58923,98
2020-06-07,ME,2570,56399,58969,99
2020-06-08,ME,2588,59057,61645,99
2020-06-09,ME,2606,59814,62420,100
2020-06-10,ME,2637,61303,63940,100
2020-06-11,ME,2667,62790,65457,100
2020-06-12,ME,2721,64166,66887,100
2020-06-13,ME,2757,65593,68350,100
2020-06-14,ME,2793,67065,69858,100
2020-06-15,ME,2810,68161,70971,101
2020-06-16,ME,2819,69516,72335,101
2020-06-17,ME,2836,71182,74018,102
2020-06-18,ME,2878,71182,74060,102
2020-06-19,ME,2913,74248,77161,102
2020-06-20,ME,2938,76638,79576,102
2020-06-21,ME,2957,78033,80990,102
2020-06-22,ME,2971,78033,81004,102
2020-06-23,ME,2994,78713,81707,102
2020-06-24,ME,3017,82173,85190,103
2020-06-25,ME,3070,84528,87598,103
2020-06-26,ME,3102,86752,89854,103
2020-06-27,ME,3154,88778,91932,104
2020-06-28,ME,3191,90304,93495,104
2020-06-29,ME,3219,90304,93523,105
2020-06-30,ME,3253,91699,94952,105
2020-07-01,ME,3294,93947,97241,105
2020-07-02,ME,3328,97489,100817,105
2020-07-03,ME,3373,100076,103449,105
2020-07-04,ME,3397,102548,105945,107
2020-07-05,ME,3415,104517,107932,109
2020-07-06,ME,3423,106127,109550,109
2020-07-07,ME,3440,107466,110906,110
2020-07-08,ME,3460,109478,112938,110
2020-07-09,ME,3486,112272,115758,111
2020-07-10,ME,3499,114907,118406,111
2020-07-11,ME,3520,116370,119890,112
2020-07-12,ME,3539,118775,122314,114
2020-07-13,ME,3558,120404,123962,114
2020-07-14,ME,3566,121909,125475,114
2020-07-15,ME,3578,124353,127931,114
2020-07-16,ME,3598,126864,130462,114
2020-07-17,ME,3636,129809,133445,115
2020-07-18,ME,3646,131283,134929,117
2020-07-19,ME,3687,133750,137437,117
2020-07-20,ME,3711,135511,139222,117
2020-07-21,ME,3723,138520,142243,118
2020-07-22,ME,3723,141295,145018,118
2020-07-23,ME,3737,143938,147675,118
2020-07-24,ME,3757,146863,150620,118
2020-07-25,ME,3790,149583,153373,119
2020-03-01,MI,9,0,9,0
2020-03-02,MI,18,0,18,0
2020-03-03,MI,34,0,34,0
2020-03-04,MI,52,0,52,0
2020-03-05,MI,72,8,80,0
2020-03-06,MI,98,8,106,0
2020-03-07,MI,128,18,146,0
2020-03-08,MI,168,26,194,0
2020-03-09,MI,254,36,290,0
2020-03-10,MI,358,39,397,0
2020-03-11,MI,497,57,554,0
2020-03-12,MI,702,91,793,0
2020-03-13,MI,945,133,1078,0
2020-03-14,MI,1196,205,1401,0
2020-03-15,MI,1480,205,1685,0
2020-03-16,MI,1933,272,2205,0
2020-03-17,MI,3659,879,4538,2
2020-03-18,MI,4531,1478,6009,5
2020-03-19,MI,5276,2051,7327,10
2020-03-20,MI,6219,3041,9260,13
2020-03-21,MI,7023,4086,11109,23
2020-03-22,MI,7822,4791,12613,36
2020-03-23,MI,9062,5847,14909,57
2020-03-24,MI,10155,6989,17144,86
2020-03-25,MI,11335,8842,20177,111
2020-03-26,MI,12475,11730,24205,159
2020-03-27,MI,13799,14140,27939,212
2020-03-28,MI,14865,15902,30767,283
2020-03-29,MI,15784,17417,33201,351
2020-03-30,MI,17363,23263,40626,437
2020-03-31,MI,18654,26334,44988,551
2020-04-01,MI,20246,29951,50197,676
2020-04-02,MI,21376,33443,54819,801
2020-04-03,MI,22579,37060,59639,918
2020-04-04,MI,23581,41205,64786,1030
2020-04-05,MI,24458,44154,68612,1150
2020-04-06,MI,25785,47262,73047,1291
2020-04-07,MI,26964,50344,77308,1449
2020-04-08,MI,28064,53176,81240,1600
2020-04-09,MI,29096,56430,85526,1756
2020-04-10,MI,30172,59597,89769,1917
2020-04-11,MI,30980,62241,93221,2081
2020-04-12,MI,31666,64555,96221,2249
2020-04-13,MI,32702,67063,99765,2391
2020-04-14,MI,33613,70675,104288,2532
2020-04-15,MI,34533,73828,108361,2672
2020-04-16,MI,35455,78274,113729,2841
2020-04-17,MI,36320,83268,119588,2984
2020-04-18,MI,37029,87114,124143,3107
2020-04-19,MI,37557,89758,127315,3236
2020-04-20,MI,38494,93393,131887,3347
2020-04-21,MI,39589,99667,139256,3471
2020-04-22,MI,40705,106653,147358,3602
2020-04-23,MI,41694,115005,156699,3711
2020-04-24,MI,42730,123054,165784,3818
2020-04-25,MI,43263,128955,172218,3929
2020-04-26,MI,43789,134431,178220,4036
2020-04-27,MI,44709,140972,185681,4148
2020-04-28,MI,45538,148910,194448,4247
2020-04-29,MI,46488,158373,204861,4335
2020-04-30,MI,47505,168944,216449,4434
2020-05-01,MI,48240,178807,227047,4520
2020-05-02,MI,48672,188713,237385,4579
2020-05-03,MI,49029,195361,244390,4641
2020-05-04,MI,49809,202671,252480,4722
2020-05-05,MI,50497,213091,263588,4781
2020-05-06,MI,51131,224563,275694,4839
2020-05-07,MI,51731,236184,287915,4925
2020-05-08,MI,52349,248142,300491,4987
2020-05-09,MI,52732,259265,311997,5036
2020-05-10,MI,53033,267417,320450,5081
2020-05-11,MI,54004,278293,332297,5139
2020-05-12,MI,55641,291701,347342,5188
2020-05-13,MI,56458,310242,366700,5232
2020-05-14,MI,57036,326657,383693,5278
2020-05-15,MI,57687,341827,399514,5325
2020-05-16,MI,58023,353156,411179,5357
2020-05-17,MI,58278,363548,421826,5396
2020-05-18,MI,58812,376115,434927,5427
2020-05-19,MI,59576,392208,451784,5470
2020-05-20,MI,60151,405848,465999,5514
2020-05-21,MI,60610,421788,482398,5555
2020-05-22,MI,61075,441282,502357,5586
2020-05-23,MI,61293,455556,516849,5612
2020-05-24,MI,61457,467087,528544,5640
2020-05-25,MI,61632,476325,537957,5678
2020-05-26,MI,62075,487906,549981,5703
2020-05-27,MI,62461,505609,568070,5727
2020-05-28,MI,62797,522663,585460,5751
2020-05-29,MI,63116,538868,601984,5778
2020-05-30,MI,63321,554509,617830,5802
2020-05-31,MI,63568,567192,630760,5818
2020-06-01,MI,63813,581424,645237,5843
2020-06-02,MI,64103,597072,661175,5869
2020-06-03,MI,64382,613173,677555,5884
2020-06-04,MI,64616,627907,692523,5901
2020-06-05,MI,64821,640450,705271,5909
2020-06-06,MI,64914,650942,715856,5916
2020-06-07,MI,64969,661256,726225,5927
2020-06-08,MI,65104,674060,739164,5942
2020-06-09,MI,65167,690869,756036,5951
2020-06-10,MI,65182,690869,756051,5952
2020-06-11,MI,65449,705071,770520,5985
2020-06-12,MI,65672,720615,786287,5990
2020-06-13,MI,65836,733647,799483,6013
2020-06-14,MI,66054,747444,813498,6016
2020-06-15,MI,66085,757952,824037,6017
2020-06-16,MI,66269,769265,835534,6034
2020-06-17,MI,66497,783388,849885,6036
2020-06-18,MI,66798,783388,850186,6061
2020-06-19,MI,67097,812831,879928,6067
2020-06-20,MI,67545,827089,894634,6087
2020-06-21,MI,67711,839715,907426,6090
2020-06-22,MI,67957,850060,918017,6097
2020-06-23,MI,68197,860471,928668,6109
2020-06-24,MI,68555,876250,944805,6114
2020-06-25,MI,68989,893850,962839,6133
2020-06-26,MI,69329,912377,981706,6134
2020-06-27,MI,69679,931142,1000821,6153
2020-06-28,MI,69946,946733,1016679,6158
2020-06-29,MI,70223,959152,1029375,6161
2020-06-30,MI,70728,974329,1045057,6193
2020-07-01,MI,71089,990770,1061859,6198
2020-07-02,MI,71678,1013459,1085137,6212
2020-07-03,MI,72175,1036090,1108265,6215
2020-07-04,MI,72581,1057573,1130154,6218
2020-07-05,MI,72941,1073878,1146819,6218
2020-07-06,MI,73269,1086094,1159363,6221
2020-07-07,MI,73900,1102611,1176511,6251
2020-07-08,MI,74551,1125452,1200003,6262
2020-07-09,MI,75063,1148490,1223553,6271
2020-07-10,MI,75685,1171120,1246805,6285
2020-07-11,MI,76370,1197752,1274122,6313
2020-07-12,MI,76776,1219379,1296155,6314
2020-07-13,MI,77198,1236229,1313427,6321
2020-07-14,MI,77864,1255922,1333786,6326
2020-07-15,MI,78913,1289006,1367919,6330
2020-07-16,MI,79839,1315315,1395154,6348
2020-07-17,MI,80593,1344913,1425506,6355
2020-07-18,MI,81338,1374740,1456078,6364
2020-07-19,MI,81868,1402591,1484459,6366
2020-07-20,MI,82395,1424394,1506789,6373
2020-07-21,MI,83059,1446316,1529375,6382
2020-07-22,MI,83730,1475883,1559613,6388
2020-07-23,MI,84431,1502293,1586724,6395
2020-07-24,MI,85072,1529574,1614646,6400
2020-07-25,MI,85072,1529574,1614646,6400
2020-03-06,MN,1,36,37,0
2020-03-07,MN,2,48,50,0
2020-03-08,MN,2,48,50,0
2020-03-09,MN,5,80,85,0
2020-03-10,MN,11,132,143,0
2020-03-11,MN,21,217,238,0
2020-03-12,MN,43,307,350,0
2020-03-13,MN,62,541,603,0
2020-03-14,MN,90,847,937,0
2020-03-15,MN,128,1387,1515,0
2020-03-16,MN,179,1839,2018,0
2020-03-17,MN,246,2276,2522,0
2020-03-18,MN,269,2685,2954,0
2020-03-19,MN,287,2949,3236,0
2020-03-20,MN,303,3741,4044,0
2020-03-21,MN,327,3952,4279,1
2020-03-22,MN,349,4511,4860,1
2020-03-23,MN,393,4511,4904,1
2020-03-24,MN,444,5550,5994,1
2020-03-25,MN,502,11188,11690,1
2020-03-26,MN,565,12604,13169,2
2020-03-27,MN,640,13605,14245,4
2020-03-28,MN,687,17395,18082,5
2020-03-29,MN,725,18566,19291,9
2020-03-30,MN,823,19512,20335,10
2020-03-31,MN,916,20935,21851,12
2020-04-01,MN,973,21880,22853,17
2020-04-02,MN,1056,23780,24836,18
2020-04-03,MN,1119,25063,26182,22
2020-04-04,MN,1158,26687,27845,24
2020-04-05,MN,1217,28090,29307,29
2020-04-06,MN,1330,29155,30485,30
2020-04-07,MN,1432,30603,32035,34
2020-04-08,MN,1534,31954,33488,39
2020-04-09,MN,1637,33682,35319,50
2020-04-10,MN,1732,35346,37078,57
2020-04-11,MN,1806,36898,38704,64
2020-04-12,MN,1864,38030,39894,70
2020-04-13,MN,2012,38667,40679,70
2020-04-14,MN,2165,39705,41870,79
2020-04-15,MN,2321,41245,43566,87
2020-04-16,MN,2486,42536,45022,94
2020-04-17,MN,2668,43820,46488,111
2020-04-18,MN,2788,45182,47970,121
2020-04-19,MN,2914,46288,49202,134
2020-04-20,MN,3190,46854,50044,143
2020-04-21,MN,3452,48341,51793,160
2020-04-22,MN,3758,50165,53923,179
2020-04-23,MN,4270,52144,56414,200
2020-04-24,MN,4788,54706,59494,221
2020-04-25,MN,5127,56982,62109,244
2020-04-26,MN,5512,59161,64673,272
2020-04-27,MN,6187,60503,66690,286
2020-04-28,MN,6788,63248,70036,301
2020-04-29,MN,7468,69650,77118,319
2020-04-30,MN,8116,73349,81465,343
2020-05-01,MN,8736,77214,85950,371
2020-05-02,MN,9071,80609,89680,395
2020-05-03,MN,9411,83433,92844,419
2020-05-04,MN,10235,86677,96912,428
2020-05-05,MN,10876,89202,100078,455
2020-05-06,MN,11510,93047,104557,485
2020-05-07,MN,12328,97244,109572,508
2020-05-08,MN,13040,101408,114448,534
2020-05-09,MN,13321,106040,119361,558
2020-05-10,MN,13552,111109,124661,578
2020-05-11,MN,14379,115585,129964,591
2020-05-12,MN,15043,118934,133977,614
2020-05-13,MN,15772,125502,141274,638
2020-05-14,MN,16565,131443,148008,663
2020-05-15,MN,17363,139773,157136,692
2020-05-16,MN,17705,147399,165104,709
2020-05-17,MN,18016,153069,171085,731
2020-05-18,MN,18987,158487,177474,740
2020-05-19,MN,19842,164009,183851,757
2020-05-20,MN,20609,170199,190808,786
2020-05-21,MN,21582,177506,199088,818
2020-05-22,MN,22374,186436,208810,851
2020-05-23,MN,22765,194941,217706,861
2020-05-24,MN,23121,201566,224687,878
2020-05-25,MN,23524,207816,231340,890
2020-05-26,MN,24308,213974,238282,908
2020-05-27,MN,24988,222821,247809,942
2020-05-28,MN,25559,232195,257754,977
2020-05-29,MN,26013,242124,268137,1006
2020-05-30,MN,26181,250392,276573,1036
2020-05-31,MN,26322,257133,283455,1050
2020-06-01,MN,26897,260739,287636,1060
2020-06-02,MN,27376,267931,295307,1082
2020-06-03,MN,27889,283319,311208,1097
2020-06-04,MN,28290,293858,322148,1126
2020-06-05,MN,28688,304497,333185,1159
2020-06-06,MN,28853,314744,343597,1181
2020-06-07,MN,28988,324153,353141,1197
2020-06-08,MN,29436,331476,360912,1208
2020-06-09,MN,29866,339927,369793,1228
2020-06-10,MN,30199,351634,381833,1267
2020-06-11,MN,30418,364816,395234,1280
2020-06-12,MN,30463,377589,408052,1305
2020-06-13,MN,30465,387245,417710,1314
2020-06-14,MN,30471,387239,417710,1329
2020-06-15,MN,30693,392229,422922,1335
2020-06-16,MN,30882,398263,429145,1344
2020-06-17,MN,31296,417291,448587,1357
2020-06-18,MN,31675,429204,460879,1376
2020-06-19,MN,32031,443121,475152,1393
2020-06-20,MN,32467,459576,492043,1404
2020-06-21,MN,32920,471443,504363,1412
2020-06-22,MN,33227,479910,513137,1416
2020-06-23,MN,33469,486576,520045,1425
2020-06-24,MN,33763,495880,529643,1432
2020-06-25,MN,34123,508573,542696,1441
2020-06-26,MN,34616,522662,557278,1446
2020-06-27,MN,35033,533874,568907,1452
2020-06-28,MN,35549,549868,585417,1460
2020-06-29,MN,35861,557094,592955,1470
2020-06-30,MN,36303,569013,605316,1476
2020-07-01,MN,36716,580391,617107,1482
2020-07-02,MN,37210,593217,630427,1495
2020-07-03,MN,37624,607548,645172,1503
2020-07-04,MN,37624,607548,645172,1503
2020-07-05,MN,38136,635879,674015,1508
2020-07-06,MN,38569,641124,679693,1511
2020-07-07,MN,39133,646114,685247,1514
2020-07-08,MN,39589,653381,692970,1523
2020-07-09,MN,40163,665277,705440,1528
2020-07-10,MN,40767,685058,725825,1533
2020-07-11,MN,41571,700524,742095,1537
2020-07-12,MN,42281,712771,755052,1540
2020-07-13,MN,42772,726217,768989,1542
2020-07-14,MN,43170,734444,777614,1548
2020-07-15,MN,43742,746755,790497,1558
2020-07-16,MN,44347,760865,805212,1566
2020-07-17,MN,45013,774498,819511,1573
2020-07-18,MN,45470,790492,835962,1578
2020-07-19,MN,46204,806984,853188,1581
2020-07-20,MN,47107,820303,867410,1585
2020-07-21,MN,47457,829402,876859,1588
2020-07-22,MN,47961,840590,888551,1592
2020-07-23,MN,48721,856594,905315,1601
2020-07-24,MN,49488,873388,922876,1606
2020-07-25,MN,50291,890405,940696,1611
2020-03-07,MO,0,0,0,0
2020-03-08,MO,1,0,1,0
2020-03-09,MO,1,0,1,0
2020-03-10,MO,1,0,1,0
2020-03-11,MO,1,0,1,0
2020-03-12,MO,1,64,65,0
2020-03-13,MO,2,71,73,0
2020-03-14,MO,4,90,94,0
2020-03-15,MO,5,122,127,0
2020-03-16,MO,6,164,170,0
2020-03-17,MO,8,207,215,0
2020-03-18,MO,13,253,266,0
2020-03-19,MO,24,308,332,1
2020-03-20,MO,47,369,416,1
2020-03-21,MO,73,369,442,3
2020-03-22,MO,90,369,459,3
2020-03-23,MO,183,369,552,3
2020-03-24,MO,183,369,552,3
2020-03-25,MO,356,369,725,8
2020-03-26,MO,502,369,871,8
2020-03-27,MO,669,369,1038,8
2020-03-28,MO,838,10082,10920,10
2020-03-29,MO,838,11547,12385,10
2020-03-30,MO,1031,13204,14235,13
2020-03-31,MO,1327,14614,15941,14
2020-04-01,MO,1581,15846,17427,18
2020-04-02,MO,1834,17849,19683,19
2020-04-03,MO,2113,19357,21470,19
2020-04-04,MO,2291,22614,24905,24
2020-04-05,MO,2367,24882,27249,34
2020-04-06,MO,2722,27113,29835,39
2020-04-07,MO,3037,28932,31969,53
2020-04-08,MO,3327,30783,34110,58
2020-04-09,MO,3539,34955,38494,77
2020-04-10,MO,3799,36941,40740,96
2020-04-11,MO,4024,39148,43172,109
2020-04-12,MO,4160,41040,45200,110
2020-04-13,MO,4388,41040,45428,114
2020-04-14,MO,4686,43292,47978,133
2020-04-15,MO,4895,44117,49012,147
2020-04-16,MO,5111,45537,50648,152
2020-04-17,MO,5283,46434,51717,165
2020-04-18,MO,5517,48242,53759,175
2020-04-19,MO,5667,48242,53909,176
2020-04-20,MO,5807,50206,56013,177
2020-04-21,MO,5941,51179,57120,189
2020-04-22,MO,6137,52019,58156,208
2020-04-23,MO,6321,53129,59450,218
2020-04-24,MO,6625,58582,65207,262
2020-04-25,MO,6826,60392,67218,273
2020-04-26,MO,6997,62751,69748,274
2020-04-27,MO,7171,63935,71106,288
2020-04-28,MO,7303,66200,73503,314
2020-04-29,MO,7425,69734,77159,318
2020-04-30,MO,7562,73125,80687,329
2020-05-01,MO,7835,74590,82425,337
2020-05-02,MO,8154,74590,82744,351
2020-05-03,MO,8386,74590,82976,352
2020-05-04,MO,8754,82697,91451,358
2020-05-05,MO,8916,86150,95066,377
2020-05-06,MO,9102,91645,100747,396
2020-05-07,MO,9341,94281,103622,418
2020-05-08,MO,9489,99232,108721,449
2020-05-09,MO,9666,99232,108898,472
2020-05-10,MO,9844,105702,115546,482
2020-05-11,MO,9918,105702,115620,488
2020-05-12,MO,10006,111290,121296,524
2020-05-13,MO,10142,114000,124142,542
2020-05-14,MO,10317,116793,127110,562
2020-05-15,MO,10456,124002,134458,576
2020-05-16,MO,10675,128665,139340,589
2020-05-17,MO,10789,135466,146255,594
2020-05-18,MO,10945,140393,151338,605
2020-05-19,MO,11080,143030,154110,616
2020-05-20,MO,11232,150752,161984,631
2020-05-21,MO,11340,150752,162092,661
2020-05-22,MO,11558,161388,172946,671
2020-05-23,MO,11752,136552,148304,676
2020-05-24,MO,11988,139631,151619,681
2020-05-25,MO,12167,145218,157385,685
2020-05-26,MO,12291,148007,160298,686
2020-05-27,MO,12492,153029,165521,696
2020-05-28,MO,12673,158394,171067,707
2020-05-29,MO,12795,165055,177850,738
2020-05-30,MO,12962,172468,185430,771
2020-05-31,MO,13147,180414,193561,772
2020-06-01,MO,13327,186381,199708,773
2020-06-02,MO,13575,191855,205430,783
2020-06-03,MO,13767,197586,211353,786
2020-06-04,MO,14057,204604,218661,786
2020-06-05,MO,14253,210289,224542,799
2020-06-06,MO,14442,215623,230065,809
2020-06-07,MO,14553,222305,236858,809
2020-06-08,MO,14734,226727,241461,819
2020-06-09,MO,14913,230782,245695,840
2020-06-10,MO,15187,236442,251629,848
2020-06-11,MO,15390,243650,259040,860
2020-06-12,MO,15585,249550,265135,872
2020-06-13,MO,15810,253986,269796,879
2020-06-14,MO,15810,259679,275489,879
2020-06-15,MO,16189,263752,279941,880
2020-06-16,MO,16414,268377,284791,882
2020-06-17,MO,16625,268377,285002,909
2020-06-18,MO,16908,280434,297342,946
2020-06-19,MO,17201,289083,306284,948
2020-06-20,MO,17590,293525,311115,955
2020-06-21,MO,18003,297154,315157,956
2020-06-22,MO,18143,299231,317374,961
2020-06-23,MO,18143,299231,317374,961
2020-06-24,MO,18868,308156,327024,975
2020-06-25,MO,19421,322227,341648,982
2020-06-26,MO,19914,328704,348618,990
2020-06-27,MO,20261,335029,355290,996
2020-06-28,MO,20575,340598,361173,997
2020-06-29,MO,21043,346363,367406,998
2020-06-30,MO,21551,351456,373007,1015
2020-07-01,MO,21927,367813,389740,1017
2020-07-02,MO,22283,375035,397318,1022
2020-07-03,MO,22830,382129,404959,1026
2020-07-04,MO,23215,389046,412261,1027
2020-07-05,MO,23436,396073,419509,1028
2020-07-06,MO,23856,402889,426745,1028
2020-07-07,MO,24629,410719,435348,1042
2020-07-08,MO,25204,417136,442340,1046
2020-07-09,MO,25999,428826,454825,1051
2020-07-10,MO,25999,428826,454825,1051
2020-07-11,MO,27133,447417,474550,1069
2020-07-12,MO,27443,458065,485508,1069
2020-07-13,MO,27890,467887,495777,1083
2020-07-14,MO,28826,476277,505103,1093
2020-07-15,MO,29714,488233,517947,1102
2020-07-16,MO,30422,498879,529301,1113
2020-07-17,MO,31288,506608,537896,1121
2020-07-18,MO,32248,518628,550876,1130
2020-07-19,MO,33094,525985,559079,1129
2020-07-20,MO,33624,538288,571912,1132
2020-07-21,MO,34762,545558,580320,1143
2020-07-22,MO,36063,553397,589460,1159
2020-07-23,MO,37700,565584,603284,1179
2020-07-24,MO,39352,573263,612615,1178
2020-07-25,MO,40709,579012,619721,1182
2020-03-16,MP,0,0,0,0
2020-03-17,MP,0,0,0,0
2020-03-18,MP,0,0,0,0
2020-03-19,MP,0,0,0,0
2020-03-20,MP,0,0,0,0
2020-03-21,MP,0,0,0,0
2020-03-22,MP,0,0,0,0
2020-03-23,MP,0,0,0,0
2020-03-24,MP,0,0,0,0
2020-03-25,MP,0,0,0,0
2020-03-26,MP,0,0,0,0
2020-03-27,MP,0,0,0,0
2020-03-28,MP,2,0,2,0
2020-03-29,MP,2,0,2,0
2020-03-30,MP,2,0,2,0
2020-03-31,MP,2,0,2,0
2020-04-01,MP,6,0,6,0
2020-04-02,MP,8,13,21,1
2020-04-03,MP,8,13,21,1
2020-04-04,MP,8,13,21,1
2020-04-05,MP,8,13,21,1
2020-04-06,MP,8,13,21,1
2020-04-07,MP,8,15,23,2
2020-04-08,MP,11,27,38,2
2020-04-09,MP,11,27,38,2
2020-04-10,MP,11,27,38,2
2020-04-11,MP,11,27,38,2
2020-04-12,MP,11,27,38,2
2020-04-13,MP,11,27,38,2
2020-04-14,MP,13,27,40,2
2020-04-15,MP,13,27,40,2
2020-04-16,MP,13,27,40,2
2020-04-17,MP,13,42,55,2
2020-04-18,MP,14,42,56,2
2020-04-19,MP,14,42,56,2
2020-04-20,MP,14,51,65,2
2020-04-21,MP,14,51,65,2
2020-04-22,MP,14,51,65,2
2020-04-23,MP,14,51,65,2
2020-04-24,MP,14,51,65,2
2020-04-25,MP,14,51,65,2
2020-04-26,MP,14,51,65,2
2020-04-27,MP,14,51,65,2
2020-04-28,MP,14,51,65,2
2020-04-29,MP,14,210,224,2
2020-04-30,MP,14,585,599,2
2020-05-01,MP,14,749,763,2
2020-05-02,MP,14,934,948,2
2020-05-03,MP,14,1321,1335,2
2020-05-04,MP,14,1321,1335,2
2020-05-05,MP,14,1783,1797,2
2020-05-06,MP,15,1783,1798,2
2020-05-07,MP,15,1783,1798,2
2020-05-08,MP,15,2321,2336,2
2020-05-09,MP,16,2321,2337,2
2020-05-10,MP,16,2321,2337,2
2020-05-11,MP,19,2676,2695,2
2020-05-12,MP,19,2854,2873,2
2020-05-13,MP,19,3021,3040,2
2020-05-14,MP,19,3306,3325,2
2020-05-15,MP,19,3306,3325,2
2020-05-16,MP,21,3318,3339,2
2020-05-17,MP,21,3318,3339,2
2020-05-18,MP,21,3399,3420,2
2020-05-19,MP,21,3796,3817,2
2020-05-20,MP,21,3796,3817,2
2020-05-21,MP,22,4067,4089,2
2020-05-22,MP,22,4296,4318,2
2020-05-23,MP,22,4296,4318,2
2020-05-24,MP,22,4735,4757,2
2020-05-25,MP,22,4735,4757,2
2020-05-26,MP,22,4918,4940,2
2020-05-27,MP,22,5178,5200,2
2020-05-28,MP,22,5401,5423,2
2020-05-29,MP,22,5662,5684,2
2020-05-30,MP,22,5986,6008,2
2020-05-31,MP,22,6151,6173,2
2020-06-01,MP,22,6312,6334,2
2020-06-02,MP,23,6534,6557,2
2020-06-03,MP,23,6534,6557,2
2020-06-04,MP,26,6669,6695,2
2020-06-05,MP,26,6669,6695,2
2020-06-06,MP,26,6669,6695,2
2020-06-07,MP,27,7214,7241,2
2020-06-08,MP,28,7214,7242,2
2020-06-09,MP,30,7493,7523,2
2020-06-10,MP,30,7493,7523,2
2020-06-11,MP,30,7551,7581,2
2020-06-12,MP,30,7732,7762,2
2020-06-13,MP,30,7906,7936,2
2020-06-14,MP,30,8139,8169,2
2020-06-15,MP,30,8139,8169,2
2020-06-16,MP,30,8139,8169,2
2020-06-17,MP,30,8139,8169,2
2020-06-18,MP,30,8139,8169,2
2020-06-19,MP,30,8139,8169,2
2020-06-20,MP,30,8139,8169,2
2020-06-21,MP,30,8139,8169,2
2020-06-22,MP,30,8139,8169,2
2020-06-23,MP,30,8187,8217,2
2020-06-24,MP,30,8187,8217,2
2020-06-25,MP,30,8187,8217,2
2020-06-26,MP,30,8187,8217,2
2020-06-27,MP,30,8187,8217,2
2020-06-28,MP,30,8187,8217,2
2020-06-29,MP,30,8187,8217,2
2020-06-30,MP,30,8187,8217,2
2020-07-01,MP,30,8187,8217,2
2020-07-02,MP,30,8187,8217,2
2020-07-03,MP,31,8187,8218,2
2020-07-04,MP,31,8187,8218,2
2020-07-05,MP,31,8187,8218,2
2020-07-06,MP,31,8187,8218,2
2020-07-07,MP,31,8187,8218,2
2020-07-08,MP,31,10734,10765,2
2020-07-09,MP,31,10734,10765,2
2020-07-10,MP,31,10734,10765,2
2020-07-11,MP,31,10734,10765,2
2020-07-12,MP,33,10734,10767,2
2020-07-13,MP,33,10734,10767,2
2020-07-14,MP,33,10664,10697,2
2020-07-15,MP,36,10664,10700,2
2020-07-16,MP,36,10664,10700,2
2020-07-17,MP,37,10664,10701,2
2020-07-18,MP,37,10664,10701,2
2020-07-19,MP,37,10664,10701,2
2020-07-20,MP,37,11055,11092,2
2020-07-21,MP,38,11055,11093,2
2020-07-22,MP,38,12707,12745,2
2020-07-23,MP,38,11300,11338,2
2020-07-24,MP,38,11300,11338,2
2020-07-25,MP,39,11300,11339,2
2020-03-07,MS,0,0,0,0
2020-03-08,MS,0,0,0,0
2020-03-09,MS,0,0,0,0
2020-03-10,MS,0,0,0,0
2020-03-11,MS,0,20,20,0
2020-03-12,MS,1,41,42,0
2020-03-13,MS,4,41,45,0
2020-03-14,MS,6,84,90,0
2020-03-15,MS,10,84,94,0
2020-03-16,MS,12,277,289,0
2020-03-17,MS,21,368,389,0
2020-03-18,MS,34,479,513,0
2020-03-19,MS,50,552,602,0
2020-03-20,MS,80,695,775,1
2020-03-21,MS,140,695,835,1
2020-03-22,MS,207,1114,1321,1
2020-03-23,MS,249,1143,1392,1
2020-03-24,MS,320,1552,1872,1
2020-03-25,MS,377,1566,1943,2
2020-03-26,MS,485,2291,2776,6
2020-03-27,MS,579,2560,3139,8
2020-03-28,MS,663,2560,3223,13
2020-03-29,MS,758,2560,3318,14
2020-03-30,MS,847,2989,3836,16
2020-03-31,MS,937,3537,4474,20
2020-04-01,MS,1073,3712,4785,22
2020-04-02,MS,1177,4753,5930,26
2020-04-03,MS,1358,4753,6111,29
2020-04-04,MS,1455,5133,6588,35
2020-04-05,MS,1638,5580,7218,43
2020-04-06,MS,1738,18632,20370,51
2020-04-07,MS,1915,18632,20547,59
2020-04-08,MS,2003,18632,20635,67
2020-04-09,MS,2260,18632,20892,76
2020-04-10,MS,2469,18632,21101,82
2020-04-11,MS,2642,18632,21274,93
2020-04-12,MS,2781,18632,21413,96
2020-04-13,MS,2942,28042,30984,98
2020-04-14,MS,3087,34791,37878,111
2020-04-15,MS,3360,34791,38151,122
2020-04-16,MS,3624,34791,38415,129
2020-04-17,MS,3793,34791,38584,140
2020-04-18,MS,3974,34791,38765,152
2020-04-19,MS,4274,34791,39065,159
2020-04-20,MS,4512,46922,51434,169
2020-04-21,MS,4716,47648,52364,183
2020-04-22,MS,4894,48941,53835,193
2020-04-23,MS,5153,50236,55389,201
2020-04-24,MS,5434,50236,55670,209
2020-04-25,MS,5718,53239,58957,221
2020-04-26,MS,5911,54877,60788,227
2020-04-27,MS,6094,57368,63462,229
2020-04-28,MS,6342,58070,64412,239
2020-04-29,MS,6569,59525,66094,250
2020-04-30,MS,6815,59525,66340,261
2020-05-01,MS,7212,64336,71548,281
2020-05-02,MS,7441,67034,74475,291
2020-05-03,MS,7550,70043,77593,303
2020-05-04,MS,7877,71800,79677,310
2020-05-05,MS,8207,72101,80308,342
2020-05-06,MS,8424,72101,80525,374
2020-05-07,MS,8686,72101,80787,396
2020-05-08,MS,9090,72101,81191,409
2020-05-09,MS,9378,72101,81479,421
2020-05-10,MS,9501,72101,81602,430
2020-05-11,MS,9674,86211,95885,435
2020-05-12,MS,9908,87784,97692,457
2020-05-13,MS,10090,89958,100048,465
2020-05-14,MS,10483,94843,105326,480
2020-05-15,MS,10801,96022,106823,493
2020-05-16,MS,11123,97353,108476,510
2020-05-17,MS,11296,101830,113126,521
2020-05-18,MS,11432,104335,115767,528
2020-05-19,MS,11704,106056,117760,554
2020-05-20,MS,11967,108713,120680,570
2020-05-21,MS,12222,113748,125970,580
2020-05-22,MS,12624,125349,137973,596
2020-05-23,MS,13005,121215,134220,616
2020-05-24,MS,13252,124650,137902,625
2020-05-25,MS,13458,130459,143917,635
2020-05-26,MS,13731,134088,147819,652
2020-05-27,MS,14044,134088,148132,670
2020-05-28,MS,14372,142125,156497,693
2020-05-29,MS,14790,151518,166308,710
2020-05-30,MS,15229,150703,165932,723
2020-05-31,MS,15501,156336,171837,734
2020-06-01,MS,15752,160502,176254,739
2020-06-02,MS,16020,163478,179498,767
2020-06-03,MS,16322,168425,184747,782
2020-06-04,MS,16560,168425,184985,794
2020-06-05,MS,16759,176354,193113,803
2020-06-06,MS,16769,176354,193123,803
2020-06-07,MS,17270,185979,203249,817
2020-06-08,MS,17768,190444,208212,837
2020-06-09,MS,17768,190444,208212,837
2020-06-10,MS,18483,195402,213885,868
2020-06-11,MS,18483,195402,213885,868
2020-06-12,MS,19091,195402,214493,881
2020-06-13,MS,19348,194537,213885,889
2020-06-14,MS,19516,194537,214053,891
2020-06-15,MS,19799,210704,230503,895
2020-06-16,MS,20152,220651,240803,915
2020-06-17,MS,20641,223748,244389,938
2020-06-18,MS,20641,218074,238715,938
2020-06-19,MS,20641,218074,238715,938
2020-06-20,MS,20641,218074,238715,938
2020-06-21,MS,20641,218074,238715,938
2020-06-22,MS,22287,230962,253249,978
2020-06-23,MS,22898,230962,253860,989
2020-06-24,MS,23424,238237,261661,1011
2020-06-25,MS,24516,241481,265997,1016
2020-06-26,MS,25066,246828,271894,1022
2020-06-27,MS,25531,251790,277321,1035
2020-06-28,MS,25892,254296,280188,1039
2020-06-29,MS,26567,256955,283522,1059
2020-06-30,MS,27247,260299,287546,1073
2020-07-01,MS,27900,265852,293752,1082
2020-07-02,MS,28770,270269,299039,1092
2020-07-03,MS,28770,270269,299039,1092
2020-07-04,MS,30674,279241,309915,1107
2020-07-05,MS,30900,279241,310141,1111
2020-07-06,MS,31257,283431,314688,1114
2020-07-07,MS,32214,283431,315645,1158
2020-07-08,MS,32888,283431,316319,1188
2020-07-09,MS,33591,291213,324804,1204
2020-07-10,MS,34622,295690,330312,1215
2020-07-11,MS,35419,298924,334343,1230
2020-07-12,MS,36287,298924,335211,1249
2020-07-13,MS,36680,306735,343415,1250
2020-07-14,MS,37542,312671,350213,1272
2020-07-15,MS,38567,318290,356857,1290
2020-07-16,MS,39797,324103,363900,1308
2020-07-17,MS,40829,330635,371464,1332
2020-07-18,MS,41846,335439,377285,1346
2020-07-19,MS,42638,335439,378077,1355
2020-07-20,MS,43889,346086,389975,1358
2020-07-21,MS,45524,349674,395198,1389
2020-07-22,MS,47071,355959,403030,1423
2020-07-23,MS,48053,355959,404012,1436
2020-07-24,MS,49663,361817,411480,1463
2020-07-25,MS,51097,370789,421886,1480
2020-03-07,MT,0,11,11,0
2020-03-08,MT,0,11,11,0
2020-03-09,MT,0,11,11,0
2020-03-10,MT,0,15,15,0
2020-03-11,MT,0,21,21,0
2020-03-12,MT,1,34,35,0
2020-03-13,MT,1,55,56,0
2020-03-14,MT,5,103,108,0
2020-03-15,MT,7,103,110,0
2020-03-16,MT,7,198,205,0
2020-03-17,MT,8,303,311,0
2020-03-18,MT,10,499,509,0
2020-03-19,MT,12,761,773,0
2020-03-20,MT,16,931,947,0
2020-03-21,MT,20,1146,1166,0
2020-03-22,MT,31,1146,1177,0
2020-03-23,MT,34,1146,1180,0
2020-03-24,MT,46,1643,1689,0
2020-03-25,MT,53,1948,2001,0
2020-03-26,MT,71,2128,2199,0
2020-03-27,MT,108,2590,2698,0
2020-03-28,MT,129,3256,3385,1
2020-03-29,MT,154,4143,4297,1
2020-03-30,MT,171,4143,4314,4
2020-03-31,MT,184,4234,4418,4
2020-04-01,MT,208,4710,4918,5
2020-04-02,MT,227,5093,5320,5
2020-04-03,MT,243,5333,5576,5
2020-04-04,MT,265,5912,6177,5
2020-04-05,MT,286,6317,6603,6
2020-04-06,MT,299,6491,6790,6
2020-04-07,MT,319,6666,6985,6
2020-04-08,MT,332,7066,7398,6
2020-04-09,MT,354,7506,7860,6
2020-04-10,MT,365,7932,8297,6
2020-04-11,MT,377,8204,8581,6
2020-04-12,MT,387,8526,8913,6
2020-04-13,MT,394,8704,9098,7
2020-04-14,MT,399,8835,9234,7
2020-04-15,MT,404,9179,9583,7
2020-04-16,MT,415,9521,9936,7
2020-04-17,MT,422,9822,10244,8
2020-04-18,MT,426,10143,10569,10
2020-04-19,MT,433,10465,10898,10
2020-04-20,MT,433,10618,11051,10
2020-04-21,MT,437,10804,11241,12
2020-04-22,MT,439,11144,11583,14
2020-04-23,MT,442,11433,11875,14
2020-04-24,MT,444,11683,12127,14
2020-04-25,MT,445,12052,12497,14
2020-04-26,MT,448,12414,12862,14
2020-04-27,MT,449,12584,13033,14
2020-04-28,MT,451,12740,13191,15
2020-04-29,MT,451,13077,13528,16
2020-04-30,MT,453,13461,13914,16
2020-05-01,MT,453,13750,14203,16
2020-05-02,MT,455,14180,14635,16
2020-05-03,MT,455,14552,15007,16
2020-05-04,MT,457,14631,15088,16
2020-05-05,MT,456,14816,15272,16
2020-05-06,MT,456,19248,19704,16
2020-05-07,MT,456,19791,20247,16
2020-05-08,MT,458,20487,20945,16
2020-05-09,MT,458,20871,21329,16
2020-05-10,MT,458,21246,21704,16
2020-05-11,MT,459,22113,22572,16
2020-05-12,MT,461,22574,23035,16
2020-05-13,MT,462,23390,23852,16
2020-05-14,MT,462,24087,24549,16
2020-05-15,MT,466,24952,25418,16
2020-05-16,MT,468,25623,26091,16
2020-05-17,MT,468,26417,26885,16
2020-05-18,MT,470,27697,28167,16
2020-05-19,MT,471,28479,28950,16
2020-05-20,MT,478,29248,29726,16
2020-05-21,MT,479,30045,30524,16
2020-05-22,MT,479,31378,31857,16
2020-05-23,MT,479,32173,32652,16
2020-05-24,MT,479,32902,33381,16
2020-05-25,MT,479,33203,33682,16
2020-05-26,MT,479,33355,33834,17
2020-05-27,MT,481,35162,35643,17
2020-05-28,MT,485,36308,36793,17
2020-05-29,MT,493,38036,38529,17
2020-05-30,MT,505,38779,39284,17
2020-05-31,MT,515,39283,39798,17
2020-06-01,MT,519,40138,40657,17
2020-06-02,MT,523,41689,42212,17
2020-06-03,MT,525,42923,43448,17
2020-06-04,MT,539,44103,44642,17
2020-06-05,MT,541,45347,45888,18
2020-06-06,MT,540,46214,46754,18
2020-06-07,MT,545,46833,47378,18
2020-06-08,MT,548,51044,51592,18
2020-06-09,MT,554,52630,53184,18
2020-06-10,MT,561,54055,54616,18
2020-06-11,MT,563,55214,55777,18
2020-06-12,MT,573,56449,57022,18
2020-06-13,MT,588,57416,58004,18
2020-06-14,MT,601,58306,58907,19
2020-06-15,MT,609,60328,60937,19
2020-06-16,MT,614,62963,63577,19
2020-06-17,MT,630,64885,65515,20
2020-06-18,MT,655,66215,66870,20
2020-06-19,MT,666,67756,68422,20
2020-06-20,MT,698,68832,69530,20
2020-06-21,MT,717,69640,70357,20
2020-06-22,MT,740,70565,71305,21
2020-06-23,MT,743,73180,73923,21
2020-06-24,MT,766,74300,75066,21
2020-06-25,MT,803,77529,78332,21
2020-06-26,MT,829,79332,80161,22
2020-06-27,MT,852,80395,81247,22
2020-06-28,MT,863,81611,82474,22
2020-06-29,MT,919,87824,88743,22
2020-06-30,MT,967,89894,90861,22
2020-07-01,MT,1016,92314,93330,22
2020-07-02,MT,1083,94066,95149,22
2020-07-03,MT,1128,96375,97503,23
2020-07-04,MT,1167,97783,98950,23
2020-07-05,MT,1212,98894,100106,23
2020-07-06,MT,1249,101677,102926,23
2020-07-07,MT,1327,104000,105327,23
2020-07-08,MT,1371,105050,106421,23
2020-07-09,MT,1466,107299,108765,25
2020-07-10,MT,1593,110585,112178,28
2020-07-11,MT,1677,111682,113359,29
2020-07-12,MT,1758,112903,114661,29
2020-07-13,MT,1843,116852,118695,32
2020-07-14,MT,1952,119444,121396,34
2020-07-15,MT,2096,121662,123758,34
2020-07-16,MT,2231,125609,127840,35
2020-07-17,MT,2366,128038,130404,37
2020-07-18,MT,2471,129408,131879,37
2020-07-19,MT,2533,130626,133159,37
2020-07-20,MT,2621,136421,139042,39
2020-07-21,MT,2712,138290,141002,40
2020-07-22,MT,2813,140705,143518,42
2020-07-23,MT,2910,143308,146218,43
2020-07-24,MT,3039,146161,149200,46
2020-07-25,MT,3260,147755,151015,46
2020-03-04,NC,1,0,1,0
2020-03-05,NC,1,0,1,0
2020-03-06,NC,2,0,2,0
2020-03-07,NC,2,0,2,0
2020-03-08,NC,2,0,2,0
2020-03-09,NC,2,0,2,0
2020-03-10,NC,7,0,7,0
2020-03-11,NC,7,0,7,0
2020-03-12,NC,12,60,72,0
2020-03-13,NC,15,86,101,0
2020-03-14,NC,23,137,160,0
2020-03-15,NC,32,227,259,0
2020-03-16,NC,33,296,329,0
2020-03-17,NC,40,474,514,0
2020-03-18,NC,63,1787,1850,0
2020-03-19,NC,97,2408,2505,0
2020-03-20,NC,137,3096,3233,0
2020-03-21,NC,184,5092,5276,0
2020-03-22,NC,255,6183,6438,0
2020-03-23,NC,297,8141,8438,0
2020-03-24,NC,398,8141,8539,0
2020-03-25,NC,504,9985,10489,1
2020-03-26,NC,636,12274,12910,2
2020-03-27,NC,763,14373,15136,3
2020-03-28,NC,935,16592,17527,4
2020-03-29,NC,1040,17905,18945,4
2020-03-30,NC,1307,19557,20864,6
2020-03-31,NC,1498,21608,23106,8
2020-04-01,NC,1584,24659,26243,10
2020-04-02,NC,1857,26822,28679,16
2020-04-03,NC,2093,29505,31598,19
2020-04-04,NC,2402,36371,38773,24
2020-04-05,NC,2585,37460,40045,31
2020-04-06,NC,2870,37856,40726,33
2020-04-07,NC,3221,37861,41082,46
2020-04-08,NC,3426,39561,42987,53
2020-04-09,NC,3651,44158,47809,65
2020-04-10,NC,3908,53737,57645,74
2020-04-11,NC,4312,56081,60393,80
2020-04-12,NC,4520,57619,62139,81
2020-04-13,NC,4816,58572,63388,86
2020-04-14,NC,5024,60015,65039,108
2020-04-15,NC,5123,62704,67827,117
2020-04-16,NC,5465,65452,70917,131
2020-04-17,NC,5859,67122,72981,152
2020-04-18,NC,6140,70071,76211,164
2020-04-19,NC,6493,72279,78772,172
2020-04-20,NC,6764,72720,79484,179
2020-04-21,NC,6951,76380,83331,213
2020-04-22,NC,7220,83116,90336,242
2020-04-23,NC,7608,88577,96185,253
2020-04-24,NC,8052,92532,100584,269
2020-04-25,NC,8623,96642,105265,289
2020-04-26,NC,8830,99064,107894,299
2020-04-27,NC,9142,100778,109920,306
2020-04-28,NC,9568,103184,112752,342
2020-04-29,NC,9948,108492,118440,354
2020-04-30,NC,10509,117527,128036,378
2020-05-01,NC,10923,122909,133832,399
2020-05-02,NC,11509,127966,139475,420
2020-05-03,NC,11664,132171,143835,422
2020-05-04,NC,11848,134591,146439,430
2020-05-05,NC,12256,139544,151800,452
2020-05-06,NC,12758,151724,164482,477
2020-05-07,NC,13397,157931,171328,507
2020-05-08,NC,13868,164745,178613,527
2020-05-09,NC,14360,172002,186362,544
2020-05-10,NC,14764,177371,192135,547
2020-05-11,NC,15045,180820,195865,550
2020-05-12,NC,15346,186898,202244,577
2020-05-13,NC,15816,194641,210457,597
2020-05-14,NC,16507,202761,219268,615
2020-05-15,NC,17129,214418,231547,641
2020-05-16,NC,17982,220604,238586,652
2020-05-17,NC,18512,230432,248944,659
2020-05-18,NC,19023,236732,255755,661
2020-05-19,NC,19700,245308,265008,691
2020-05-20,NC,20122,257481,277603,702
2020-05-21,NC,20860,269785,290645,716
2020-05-22,NC,21618,281606,303224,728
2020-05-23,NC,22725,306857,329582,737
2020-05-24,NC,23222,313434,336656,744
2020-05-25,NC,23964,320726,344690,754
2020-05-26,NC,24140,328191,352331,766
2020-05-27,NC,24628,339528,364156,794
2020-05-28,NC,25412,349780,375192,827
2020-05-29,NC,26488,364743,391231,859
2020-05-30,NC,27673,376484,404157,877
2020-05-31,NC,28589,387700,416289,886
2020-06-01,NC,29263,392645,421908,898
2020-06-02,NC,29889,405032,434921,921
2020-06-03,NC,30777,418486,449263,939
2020-06-04,NC,31966,436336,468302,960
2020-06-05,NC,33255,448892,482147,966
2020-06-06,NC,34625,462725,497350,992
2020-06-07,NC,35546,475680,511226,996
2020-06-08,NC,36484,483629,520113,1006
2020-06-09,NC,37160,498551,535711,1029
2020-06-10,NC,38171,515479,553650,1053
2020-06-11,NC,39481,533196,572677,1064
2020-06-12,NC,41249,554448,595697,1092
2020-06-13,NC,42676,569014,611690,1104
2020-06-14,NC,44119,583011,627130,1109
2020-06-15,NC,45102,593377,638479,1118
2020-06-16,NC,45853,605568,651421,1154
2020-06-17,NC,46855,620567,667422,1168
2020-06-18,NC,48188,645490,693678,1175
2020-06-19,NC,49840,662473,712313,1197
2020-06-20,NC,51389,679952,731341,1212
2020-06-21,NC,52801,692974,745775,1220
2020-06-22,NC,53605,703740,757345,1223
2020-06-23,NC,54453,719375,773828,1251
2020-06-24,NC,56174,735111,791285,1266
2020-06-25,NC,57183,754095,811278,1284
2020-06-26,NC,58818,777907,836725,1303
2020-06-27,NC,60537,794594,855131,1312
2020-06-28,NC,62142,809763,871905,1322
2020-06-29,NC,63484,822821,886305,1325
2020-06-30,NC,64670,845363,910033,1343
2020-07-01,NC,66513,875725,942238,1373
2020-07-02,NC,68142,902978,971120,1391
2020-07-03,NC,70241,929052,999293,1392
2020-07-04,NC,71654,946642,1018296,1395
2020-07-05,NC,72983,963855,1036838,1396
2020-07-06,NC,74529,977317,1051846,1398
2020-07-07,NC,75875,995415,1071290,1420
2020-07-08,NC,77310,1019372,1096682,1441
2020-07-09,NC,79349,1042462,1121811,1461
2020-07-10,NC,81331,1069281,1150612,1479
2020-07-11,NC,83793,1092265,1176058,1499
2020-07-12,NC,85701,1113874,1199575,1503
2020-07-13,NC,87528,1132958,1220486,1510
2020-07-14,NC,89484,1165362,1254846,1552
2020-07-15,NC,91266,1193371,1284637,1568
2020-07-16,NC,93426,1219331,1312757,1588
2020-07-17,NC,95477,1248497,1343974,1606
2020-07-18,NC,97958,1281185,1379143,1629
2020-07-19,NC,99778,1295086,1394864,1634
2020-07-20,NC,101046,1322842,1423888,1642
2020-07-21,NC,102861,1356136,1458997,1668
2020-07-22,NC,105001,1386819,1491820,1698
2020-07-23,NC,106893,1416782,1523675,1726
2020-07-24,NC,108995,1441302,1550297,1746
2020-07-25,NC,111092,1467950,1579042,1778
2020-03-07,ND,0,0,0,0
2020-03-08,ND,0,0,0,0
2020-03-09,ND,0,0,0,0
2020-03-10,ND,0,6,6,0
2020-03-11,ND,0,7,7,0
2020-03-12,ND,1,12,13,0
2020-03-13,ND,1,39,40,0
2020-03-14,ND,1,54,55,0
2020-03-15,ND,1,95,96,0
2020-03-16,ND,1,123,124,0
2020-03-17,ND,3,220,223,0
2020-03-18,ND,6,268,274,0
2020-03-19,ND,15,493,508,0
2020-03-20,ND,20,800,820,0
2020-03-21,ND,28,1141,1169,0
2020-03-22,ND,28,1260,1288,0
2020-03-23,ND,30,1353,1383,0
2020-03-24,ND,34,1454,1488,0
2020-03-25,ND,39,1734,1773,0
2020-03-26,ND,52,2039,2091,0
2020-03-27,ND,65,2427,2492,0
2020-03-28,ND,83,2809,2892,1
2020-03-29,ND,98,3355,3453,1
2020-03-30,ND,109,3728,3837,2
2020-03-31,ND,126,4131,4257,3
2020-04-01,ND,142,4351,4493,3
2020-04-02,ND,159,4821,4980,3
2020-04-03,ND,173,5625,5798,3
2020-04-04,ND,186,6021,6207,3
2020-04-05,ND,207,6580,6787,3
2020-04-06,ND,225,6988,7213,3
2020-04-07,ND,237,7466,7703,4
2020-04-08,ND,251,8301,8552,4
2020-04-09,ND,269,8721,8990,5
2020-04-10,ND,278,9330,9608,6
2020-04-11,ND,293,9787,10080,7
2020-04-12,ND,308,10042,10350,8
2020-04-13,ND,331,10450,10781,8
2020-04-14,ND,341,10575,10916,9
2020-04-15,ND,365,10952,11317,9
2020-04-16,ND,393,11311,11704,9
2020-04-17,ND,439,11903,12342,9
2020-04-18,ND,528,12435,12963,9
2020-04-19,ND,585,13045,13630,10
2020-04-20,ND,627,14120,14747,13
2020-04-21,ND,644,14343,14987,13
2020-04-22,ND,679,14910,15589,14
2020-04-23,ND,709,15621,16330,15
2020-04-24,ND,748,16701,17449,15
2020-04-25,ND,803,18547,19350,16
2020-04-26,ND,867,19850,20717,17
2020-04-27,ND,942,21492,22434,19
2020-04-28,ND,991,22732,23723,19
2020-04-29,ND,1033,24503,25536,19
2020-04-30,ND,1067,26393,27460,19
2020-05-01,ND,1107,28418,29525,23
2020-05-02,ND,1153,30394,31547,24
2020-05-03,ND,1191,32162,33353,16
2020-05-04,ND,1225,33529,34754,15
2020-05-05,ND,1266,35155,36421,17
2020-05-06,ND,1323,37309,38632,22
2020-05-07,ND,1371,39496,40867,23
2020-05-08,ND,1425,41076,42501,24
2020-05-09,ND,1464,42469,43933,24
2020-05-10,ND,1491,43378,44869,24
2020-05-11,ND,1518,45496,47014,24
2020-05-12,ND,1571,46261,47832,25
2020-05-13,ND,1647,47298,48945,29
2020-05-14,ND,1647,48599,50246,31
2020-05-15,ND,1761,49954,51715,35
2020-05-16,ND,1848,51639,53487,35
2020-05-17,ND,1900,53321,55221,35
2020-05-18,ND,1931,54630,56561,37
2020-05-19,ND,1994,55737,57731,37
2020-05-20,ND,2095,57105,59200,37
2020-05-21,ND,2229,59050,61279,38
2020-05-22,ND,2317,60513,62830,39
2020-05-23,ND,2365,61783,64148,39
2020-05-24,ND,2418,63070,65488,39
2020-05-25,ND,2457,63893,66350,39
2020-05-26,ND,2422,64432,66854,40
2020-05-27,ND,2439,64901,67340,44
2020-05-28,ND,2481,65773,68254,48
2020-05-29,ND,2520,66933,69453,48
2020-05-30,ND,2554,68427,70981,48
2020-05-31,ND,2577,69463,72040,48
2020-06-01,ND,2625,70676,73301,50
2020-06-02,ND,2646,70998,73644,54
2020-06-03,ND,2679,71823,74502,54
2020-06-04,ND,2706,73038,75744,58
2020-06-05,ND,2745,74111,76856,59
2020-06-06,ND,2816,76064,78880,59
2020-06-07,ND,2861,77072,79933,59
2020-06-08,ND,2880,77300,80180,62
2020-06-09,ND,2901,77765,80666,65
2020-06-10,ND,2941,78719,81660,67
2020-06-11,ND,2980,79808,82788,67
2020-06-12,ND,3016,81148,84164,67
2020-06-13,ND,3058,82815,85873,67
2020-06-14,ND,3080,83800,86880,67
2020-06-15,ND,3101,84675,87776,68
2020-06-16,ND,3124,85527,88651,69
2020-06-17,ND,3166,86508,89674,70
2020-06-18,ND,3193,87461,90654,70
2020-06-19,ND,3226,89380,92606,71
2020-06-20,ND,3251,90980,94231,71
2020-06-21,ND,3288,92885,96173,71
2020-06-22,ND,3313,94140,97453,72
2020-06-23,ND,3320,94233,97553,73
2020-06-24,ND,3362,95327,98689,74
2020-06-25,ND,3393,96051,99444,76
2020-06-26,ND,3421,97465,100886,77
2020-06-27,ND,3458,99061,102519,77
2020-06-28,ND,3495,100430,103925,77
2020-06-29,ND,3539,102152,105691,77
2020-06-30,ND,3576,102546,106122,78
2020-07-01,ND,3615,103611,107226,78
2020-07-02,ND,3657,104538,108195,78
2020-07-03,ND,3722,106852,110574,78
2020-07-04,ND,3779,108149,111928,78
2020-07-05,ND,3816,109312,113128,78
2020-07-06,ND,3849,109733,113582,78
2020-07-07,ND,3898,110459,114357,81
2020-07-08,ND,3971,111868,115839,78
2020-07-09,ND,4070,113779,117849,78
2020-07-10,ND,4154,115442,119596,78
2020-07-11,ND,4243,116608,120851,78
2020-07-12,ND,4334,118145,122479,78
2020-07-13,ND,4442,119436,123878,78
2020-07-14,ND,4493,120540,125033,78
2020-07-15,ND,4565,121999,126564,81
2020-07-16,ND,4668,123388,128056,82
2020-07-17,ND,4792,124683,129475,82
2020-07-18,ND,4907,126608,131515,82
2020-07-19,ND,5019,128835,133854,82
2020-07-20,ND,5126,130852,135978,82
2020-07-21,ND,5207,132086,137293,84
2020-07-22,ND,5367,133899,139266,88
2020-07-23,ND,5493,135323,140816,88
2020-07-24,ND,5614,137094,142708,88
2020-07-25,ND,5736,138524,144260,91
2020-03-05,NE,0,17,17,0
2020-03-06,NE,0,17,17,0
2020-03-07,NE,1,17,18,0
2020-03-08,NE,1,17,18,0
2020-03-09,NE,3,36,39,0
2020-03-10,NE,3,47,50,0
2020-03-11,NE,5,47,52,0
2020-03-12,NE,10,80,90,0
2020-03-13,NE,13,80,93,0
2020-03-14,NE,14,80,94,0
2020-03-15,NE,17,80,97,0
2020-03-16,NE,18,170,188,0
2020-03-17,NE,21,206,227,0
2020-03-18,NE,24,206,230,0
2020-03-19,NE,27,240,267,0
2020-03-20,NE,32,240,272,0
2020-03-21,NE,38,356,394,0
2020-03-22,NE,48,356,404,0
2020-03-23,NE,50,356,406,0
2020-03-24,NE,52,975,1027,0
2020-03-25,NE,61,1304,1365,0
2020-03-26,NE,73,1584,1657,0
2020-03-27,NE,85,1761,1846,0
2020-03-28,NE,96,1904,2000,2
2020-03-29,NE,108,1968,2076,2
2020-03-30,NE,145,2584,2729,2
2020-03-31,NE,172,2931,3103,3
2020-04-01,NE,210,3475,3685,4
2020-04-02,NE,246,3978,4224,5
2020-04-03,NE,279,4487,4766,6
2020-04-04,NE,321,5058,5379,6
2020-04-05,NE,363,5558,5921,8
2020-04-06,NE,409,6378,6787,8
2020-04-07,NE,447,6811,7258,10
2020-04-08,NE,519,7442,7961,12
2020-04-09,NE,567,8116,8683,14
2020-04-10,NE,635,8719,9354,15
2020-04-11,NE,700,9285,9985,17
2020-04-12,NE,791,9900,10691,17
2020-04-13,NE,814,10158,10972,17
2020-04-14,NE,871,10486,11357,18
2020-04-15,NE,901,10828,11729,20
2020-04-16,NE,952,11342,12294,21
2020-04-17,NE,1066,12038,13104,24
2020-04-18,NE,1138,12539,13677,24
2020-04-19,NE,1287,13288,14575,28
2020-04-20,NE,1474,14206,15680,28
2020-04-21,NE,1648,14724,16372,33
2020-04-22,NE,1722,14957,16679,38
2020-04-23,NE,1813,15547,17360,45
2020-04-24,NE,2124,16488,18612,47
2020-04-25,NE,2421,17552,19973,50
2020-04-26,NE,2732,18496,21228,53
2020-04-27,NE,3028,19335,22363,56
2020-04-28,NE,3358,20247,23605,55
2020-04-29,NE,3374,20257,23631,55
2020-04-30,NE,3784,21537,25321,68
2020-05-01,NE,4281,23104,27385,70
2020-05-02,NE,4838,24510,29348,73
2020-05-03,NE,5326,25936,31262,76
2020-05-04,NE,5910,27844,33754,78
2020-05-05,NE,6083,28526,34609,78
2020-05-06,NE,6438,29690,36128,82
2020-05-07,NE,6771,30987,37758,86
2020-05-08,NE,7190,33222,40412,90
2020-05-09,NE,7831,35145,42976,92
2020-05-10,NE,8234,37335,45569,96
2020-05-11,NE,8315,37924,46239,98
2020-05-12,NE,8572,39371,47943,100
2020-05-13,NE,8692,41033,49725,103
2020-05-14,NE,9075,44266,53341,107
2020-05-15,NE,9416,47799,57215,113
2020-05-16,NE,9772,50206,59978,119
2020-05-17,NE,10220,55420,65640,123
2020-05-18,NE,10348,57153,67501,123
2020-05-19,NE,10625,59359,69984,125
2020-05-20,NE,10846,61289,72135,132
2020-05-21,NE,11122,64518,75640,138
2020-05-22,NE,11425,66994,78419,143
2020-05-23,NE,11662,68320,79982,147
2020-05-24,NE,11989,71216,83205,147
2020-05-25,NE,12134,73598,85732,150
2020-05-26,NE,12355,75687,88042,150
2020-05-27,NE,12619,77802,90421,153
2020-05-28,NE,12976,80004,92980,163
2020-05-29,NE,13261,81542,94803,164
2020-05-30,NE,13654,85354,99008,170
2020-05-31,NE,13905,87237,101142,170
2020-06-01,NE,14101,89564,103665,170
2020-06-02,NE,14345,92073,106418,178
2020-06-03,NE,14611,95355,109966,181
2020-06-04,NE,14866,97389,112255,187
2020-06-05,NE,15117,99705,114822,186
2020-06-06,NE,15379,102168,117547,186
2020-06-07,NE,15543,104226,119769,188
2020-06-08,NE,15634,105773,121407,188
2020-06-09,NE,15752,106940,122692,188
2020-06-10,NE,15883,109279,125162,191
2020-06-11,NE,16025,111637,127662,195
2020-06-12,NE,16315,114458,130773,212
2020-06-13,NE,16513,117864,134377,216
2020-06-14,NE,16633,119482,136115,216
2020-06-15,NE,16725,121030,137755,216
2020-06-16,NE,16851,122662,139513,220
2020-06-17,NE,17031,125356,142387,231
2020-06-18,NE,17226,127587,144813,234
2020-06-19,NE,17415,130431,147846,240
2020-06-20,NE,17591,134263,151854,244
2020-06-21,NE,17707,136534,154241,244
2020-06-22,NE,17810,138698,156508,244
2020-06-23,NE,17957,140685,158642,249
2020-06-24,NE,18092,143209,161301,256
2020-06-25,NE,18221,144949,163170,257
2020-06-26,NE,18346,146656,165002,260
2020-06-27,NE,18524,150074,168598,266
2020-06-28,NE,18775,154023,172798,267
2020-06-29,NE,18899,156373,175272,267
2020-06-30,NE,19042,159115,178157,269
2020-07-01,NE,19177,161431,180608,274
2020-07-02,NE,19310,163352,182662,276
2020-07-03,NE,19452,164682,184134,282
2020-07-04,NE,19660,167928,187588,284
2020-07-05,NE,19827,170101,189928,284
2020-07-06,NE,19929,171811,191740,284
2020-07-07,NE,20046,173027,193073,283
2020-07-08,NE,20201,174847,195048,282
2020-07-09,NE,20425,177410,197835,282
2020-07-10,NE,20623,180391,201014,284
2020-07-11,NE,20777,183077,203854,286
2020-07-12,NE,20998,187105,208103,285
2020-07-13,NE,21172,190487,211659,285
2020-07-14,NE,21399,194836,216235,288
2020-07-15,NE,21717,198026,219743,286
2020-07-16,NE,21979,201250,223229,291
2020-07-17,NE,22134,204062,226196,299
2020-07-18,NE,22361,208790,231151,301
2020-07-19,NE,22481,209920,232401,301
2020-07-20,NE,22583,212313,234896,301
2020-07-21,NE,22847,215594,238441,306
2020-07-22,NE,23190,219431,242621,310
2020-07-23,NE,23486,222087,245573,311
2020-07-24,NE,23818,225256,249074,316
2020-07-25,NE,24174,228431,252605,316
2020-03-04,NH,2,10,12,0
2020-03-05,NH,2,16,18,0
2020-03-06,NH,2,20,22,0
2020-03-07,NH,2,20,22,0
2020-03-08,NH,4,38,42,0
2020-03-09,NH,4,38,42,0
2020-03-10,NH,4,38,42,0
2020-03-11,NH,4,38,42,0
2020-03-12,NH,6,94,100,0
2020-03-13,NH,6,94,100,0
2020-03-14,NH,7,212,219,0
2020-03-15,NH,13,271,284,0
2020-03-16,NH,13,271,284,0
2020-03-17,NH,17,355,372,0
2020-03-18,NH,26,513,539,0
2020-03-19,NH,39,621,660,0
2020-03-20,NH,44,745,789,0
2020-03-21,NH,55,973,1028,0
2020-03-22,NH,65,1188,1253,0
2020-03-23,NH,78,1374,1452,0
2020-03-24,NH,101,1447,1548,1
2020-03-25,NH,108,2356,2464,1
2020-03-26,NH,137,3001,3138,1
2020-03-27,NH,158,3395,3553,1
2020-03-28,NH,187,3656,3843,2
2020-03-29,NH,214,4524,4738,2
2020-03-30,NH,314,5386,5700,3
2020-03-31,NH,314,5413,5727,3
2020-04-01,NH,415,5985,6400,4
2020-04-02,NH,415,6078,6493,4
2020-04-03,NH,479,6575,7054,5
2020-04-04,NH,540,6965,7505,7
2020-04-05,NH,621,7411,8032,9
2020-04-06,NH,669,7701,8370,9
2020-04-07,NH,715,8019,8734,9
2020-04-08,NH,788,8389,9177,18
2020-04-09,NH,788,8763,9551,18
2020-04-10,NH,819,9139,9958,21
2020-04-11,NH,885,9608,10493,22
2020-04-12,NH,929,9996,10925,23
2020-04-13,NH,985,10222,11207,23
2020-04-14,NH,1020,10590,11610,23
2020-04-15,NH,1139,11027,12166,32
2020-04-16,NH,1139,11027,12166,32
2020-04-17,NH,1287,11421,12708,37
2020-04-18,NH,1287,11565,12852,37
2020-04-19,NH,1342,12082,13424,38
2020-04-20,NH,1392,12726,14118,41
2020-04-21,NH,1491,12848,14339,42
2020-04-22,NH,1491,13550,15041,42
2020-04-23,NH,1588,14424,16012,48
2020-04-24,NH,1670,15139,16809,51
2020-04-25,NH,1720,16007,17727,53
2020-04-26,NH,1787,16964,18751,60
2020-04-27,NH,1864,17860,19724,60
2020-04-28,NH,1938,18207,20145,60
2020-04-29,NH,2010,18736,20746,60
2020-04-30,NH,2054,19867,21921,66
2020-05-01,NH,2146,19903,22049,72
2020-05-02,NH,2310,22039,24349,81
2020-05-03,NH,2429,25964,28393,84
2020-05-04,NH,2588,24282,26870,86
2020-05-05,NH,2588,24282,26870,86
2020-05-06,NH,2636,25097,27733,92
2020-05-07,NH,2740,26066,28806,111
2020-05-08,NH,2843,27829,30672,114
2020-05-09,NH,2947,29351,32298,121
2020-05-10,NH,3011,30442,33453,131
2020-05-11,NH,3160,31723,34883,133
2020-05-12,NH,3160,32401,35561,133
2020-05-13,NH,3239,33977,37216,142
2020-05-14,NH,3299,35876,39175,150
2020-05-15,NH,3464,39148,42612,159
2020-05-16,NH,3464,39212,42676,159
2020-05-17,NH,3556,41196,44752,171
2020-05-18,NH,3596,41282,44878,172
2020-05-19,NH,3652,45822,49474,172
2020-05-20,NH,3721,47167,50888,182
2020-05-21,NH,3868,48962,52830,190
2020-05-22,NH,3935,51165,55100,199
2020-05-23,NH,4089,55450,59539,208
2020-05-24,NH,4089,55450,59539,208
2020-05-25,NH,4149,57237,61386,209
2020-05-26,NH,4197,58842,63039,210
2020-05-27,NH,4231,60001,64232,214
2020-05-28,NH,4286,61310,65596,223
2020-05-29,NH,4386,62476,66862,232
2020-05-30,NH,4492,64468,68960,238
2020-05-31,NH,4545,65735,70280,242
2020-06-01,NH,4651,67805,72456,245
2020-06-02,NH,4685,69659,74344,245
2020-06-03,NH,4749,70990,75739,256
2020-06-04,NH,4795,71170,75965,265
2020-06-05,NH,4876,74889,79765,273
2020-06-06,NH,5019,78990,84009,283
2020-06-07,NH,5019,78990,84009,283
2020-06-08,NH,5043,80509,85552,286
2020-06-09,NH,5079,82044,87123,286
2020-06-10,NH,5132,83515,88647,294
2020-06-11,NH,5178,84729,89907,301
2020-06-12,NH,5209,86708,91917,308
2020-06-13,NH,5251,88705,93956,315
2020-06-14,NH,5299,91122,96421,318
2020-06-15,NH,5345,93528,98873,320
2020-06-16,NH,5345,93528,98873,320
2020-06-17,NH,5364,94722,100086,326
2020-06-18,NH,5436,96548,101984,330
2020-06-19,NH,5450,98275,103725,331
2020-06-20,NH,5486,100081,105567,337
2020-06-21,NH,5518,100367,105885,339
2020-06-22,NH,5544,103318,108862,339
2020-06-23,NH,5558,103318,108876,339
2020-06-24,NH,5571,104482,110053,343
2020-06-25,NH,5598,105968,111566,347
2020-06-26,NH,5671,109097,114768,365
2020-06-27,NH,5671,109097,114768,365
2020-06-28,NH,5717,110392,116109,367
2020-06-29,NH,5760,112538,118298,367
2020-06-30,NH,5760,112538,118298,367
2020-07-01,NH,5782,113387,119169,371
2020-07-02,NH,5802,114505,120307,373
2020-07-03,NH,5822,116365,122187,375
2020-07-04,NH,5857,117892,123749,376
2020-07-05,NH,5857,117892,123749,376
2020-07-06,NH,5897,119338,125235,381
2020-07-07,NH,5914,121966,127880,382
2020-07-08,NH,5932,122579,128511,384
2020-07-09,NH,5952,123676,129628,386
2020-07-10,NH,5973,125078,131051,387
2020-07-11,NH,5991,126311,132302,390
2020-07-12,NH,6024,127365,133389,391
2020-07-13,NH,6054,128812,134866,391
2020-07-14,NH,6068,129960,136028,391
2020-07-15,NH,6091,131018,137109,392
2020-07-16,NH,6113,132159,138272,394
2020-07-17,NH,6165,135621,141786,395
2020-07-18,NH,6165,135621,141786,395
2020-07-19,NH,6203,137175,143378,398
2020-07-20,NH,6203,137175,143378,398
2020-07-21,NH,6249,138573,144822,398
2020-07-22,NH,6262,139276,145538,400
2020-07-23,NH,6295,140584,146879,402
2020-07-24,NH,6318,143474,149792,405
2020-07-25,NH,6415,145875,152290,409
2020-03-05,NJ,1,0,1,0
2020-03-06,NJ,1,0,1,0
2020-03-07,NJ,4,0,4,0
2020-03-08,NJ,6,31,37,0
2020-03-09,NJ,11,35,46,0
2020-03-10,NJ,15,44,59,0
2020-03-11,NJ,24,57,81,1
2020-03-12,NJ,30,74,104,1
2020-03-13,NJ,50,97,147,1
2020-03-14,NJ,50,97,147,1
2020-03-15,NJ,98,120,218,2
2020-03-16,NJ,178,120,298,2
2020-03-17,NJ,267,163,430,3
2020-03-18,NJ,427,190,617,5
2020-03-19,NJ,742,210,952,9
2020-03-20,NJ,890,264,1154,11
2020-03-21,NJ,1327,294,1621,16
2020-03-22,NJ,1914,327,2241,20
2020-03-23,NJ,2844,359,3203,27
2020-03-24,NJ,3675,8325,12000,44
2020-03-25,NJ,4402,10452,14854,62
2020-03-26,NJ,6876,13661,20537,81
2020-03-27,NJ,8825,16547,25372,108
2020-03-28,NJ,11124,19386,30510,140
2020-03-29,NJ,13386,22216,35602,161
2020-03-30,NJ,16636,25224,41860,198
2020-03-31,NJ,18696,27077,45773,267
2020-04-01,NJ,22255,30387,52642,355
2020-04-02,NJ,25590,33520,59110,537
2020-04-03,NJ,29895,37608,67503,646
2020-04-04,NJ,34124,41232,75356,846
2020-04-05,NJ,37505,44661,82166,917
2020-04-06,NJ,41090,47942,89032,1003
2020-04-07,NJ,44416,50558,94974,1232
2020-04-08,NJ,47437,52979,100416,1504
2020-04-09,NJ,51027,56165,107192,1700
2020-04-10,NJ,54588,58935,113523,1932
2020-04-11,NJ,58151,62042,120193,2183
2020-04-12,NJ,61850,64885,126735,2350
2020-04-13,NJ,64584,64885,129469,2443
2020-04-14,NJ,68824,70950,139774,2805
2020-04-15,NJ,71030,72991,144021,3156
2020-04-16,NJ,75317,76513,151830,3518
2020-04-17,NJ,78467,78982,157449,3840
2020-04-18,NJ,81420,81116,162536,4070
2020-04-19,NJ,85301,85387,170688,4202
2020-04-20,NJ,88806,89251,178057,4377
2020-04-21,NJ,92387,92439,184826,4753
2020-04-22,NJ,95865,95794,191659,5063
2020-04-23,NJ,99989,100159,200148,5368
2020-04-24,NJ,102196,103766,205962,5617
2020-04-25,NJ,105523,108163,213686,5863
2020-04-26,NJ,109038,114106,223144,5938
2020-04-27,NJ,111188,116587,227775,6044
2020-04-28,NJ,113856,120503,234359,6442
2020-04-29,NJ,116264,125054,241318,6770
2020-04-30,NJ,118652,129266,247918,7228
2020-05-01,NJ,121190,135355,256545,7538
2020-05-02,NJ,123717,138595,262312,7742
2020-05-03,NJ,126744,148322,275066,7871
2020-05-04,NJ,128269,148951,277220,7910
2020-05-05,NJ,130593,157030,287623,8244
2020-05-06,NJ,131890,157030,288920,8549
2020-05-07,NJ,133635,159023,292658,8801
2020-05-08,NJ,135454,163305,298759,8952
2020-05-09,NJ,137085,168121,305206,9116
2020-05-10,NJ,138532,173915,312447,9255
2020-05-11,NJ,139945,285988,425933,9310
2020-05-12,NJ,140743,292317,433060,9508
2020-05-13,NJ,141560,299890,441450,9702
2020-05-14,NJ,142704,308992,451696,9946
2020-05-15,NJ,143905,319067,462972,10138
2020-05-16,NJ,145089,330135,475224,10249
2020-05-17,NJ,146334,341231,487565,10356
2020-05-18,NJ,148039,357530,505569,10435
2020-05-19,NJ,149013,371169,520182,10586
2020-05-20,NJ,150399,380944,531343,10747
2020-05-21,NJ,151472,392802,544274,10843
2020-05-22,NJ,152719,402595,555314,10985
2020-05-23,NJ,153104,425631,578735,11081
2020-05-24,NJ,154154,449653,603807,11133
2020-05-25,NJ,155092,468705,623797,11144
2020-05-26,NJ,155764,480128,635892,11191
2020-05-27,NJ,156628,503697,660325,11339
2020-05-28,NJ,157815,528042,685857,11401
2020-05-29,NJ,158844,557567,716411,11531
2020-05-30,NJ,159608,585700,745308,11634
2020-05-31,NJ,160445,585700,746145,11698
2020-06-01,NJ,160918,634682,795600,11721
2020-06-02,NJ,161545,656132,817677,11770
2020-06-03,NJ,162068,675352,837420,11880
2020-06-04,NJ,162530,695199,857729,11970
2020-06-05,NJ,163336,755555,918891,12049
2020-06-06,NJ,163893,755555,919448,12106
2020-06-07,NJ,164164,796261,960425,12176
2020-06-08,NJ,164497,810592,975089,12214
2020-06-09,NJ,164796,824701,989497,12303
2020-06-10,NJ,165346,843588,1008934,12377
2020-06-11,NJ,165816,864977,1030793,12443
2020-06-12,NJ,166164,889232,1055396,12489
2020-06-13,NJ,166605,911610,1078215,12589
2020-06-14,NJ,166881,930735,1097616,12625
2020-06-15,NJ,167103,948980,1116083,12676
2020-06-16,NJ,167426,964356,1131782,12727
2020-06-17,NJ,167703,980138,1147841,12769
2020-06-18,NJ,168107,1003627,1171734,12800
2020-06-19,NJ,168496,1025847,1194343,12835
2020-06-20,NJ,168834,1050039,1218873,12857
2020-06-21,NJ,169142,1075825,1244967,12870
2020-06-22,NJ,169415,1097984,1267399,12895
2020-06-23,NJ,169734,1113717,1283451,12949
2020-06-24,NJ,169892,1129753,1299645,12995
2020-06-25,NJ,170196,1150714,1320910,14872
2020-06-26,NJ,170584,1176088,1346672,14914
2020-06-27,NJ,170873,1196377,1367250,14948
2020-06-28,NJ,171182,1216651,1387833,14975
2020-06-29,NJ,171272,1232712,1403984,14992
2020-06-30,NJ,171667,1250707,1422374,15035
2020-07-01,NJ,171928,1271009,1442937,15078
2020-07-02,NJ,172356,1291557,1463913,15107
2020-07-03,NJ,172742,1312759,1485501,15164
2020-07-04,NJ,173033,1335515,1508548,15189
2020-07-05,NJ,173402,1361238,1534640,15211
2020-07-06,NJ,173611,1375598,1549209,15229
2020-07-07,NJ,173878,1386255,1560133,15281
2020-07-08,NJ,174039,1403809,1577848,15423
2020-07-09,NJ,174240,1425177,1599417,15448
2020-07-10,NJ,174628,1448530,1623158,15479
2020-07-11,NJ,174959,1486325,1661284,15525
2020-07-12,NJ,175298,1510306,1685604,15541
2020-07-13,NJ,175522,1524863,1700385,15560
2020-07-14,NJ,175915,1545316,1721231,15582
2020-07-15,NJ,176278,1566069,1742347,15607
2020-07-16,NJ,176501,1583403,1759904,15665
2020-07-17,NJ,176551,1592377,1768928,15684
2020-07-18,NJ,176814,1604636,1781450,15699
2020-07-19,NJ,176783,1614354,1791137,15706
2020-07-20,NJ,176963,1625911,1802874,15715
2020-07-21,NJ,177256,1640699,1817955,15737
2020-07-22,NJ,177645,1663284,1840929,15707
2020-07-23,NJ,177887,1681751,1859638,15730
2020-07-24,NJ,178345,1709299,1887644,15765
2020-07-25,NJ,178858,1709299,1888157,15776
2020-03-06,NM,0,16,16,0
2020-03-07,NM,0,48,48,0
2020-03-08,NM,0,48,48,0
2020-03-09,NM,0,57,57,0
2020-03-10,NM,0,69,69,0
2020-03-11,NM,3,87,90,0
2020-03-12,NM,5,155,160,0
2020-03-13,NM,10,190,200,0
2020-03-14,NM,10,237,247,0
2020-03-15,NM,13,482,495,0
2020-03-16,NM,17,566,583,0
2020-03-17,NM,23,1249,1272,0
2020-03-18,NM,28,2326,2354,0
2020-03-19,NM,35,2762,2797,0
2020-03-20,NM,43,3771,3814,0
2020-03-21,NM,57,3771,3828,0
2020-03-22,NM,57,4722,4779,0
2020-03-23,NM,65,5321,5386,0
2020-03-24,NM,83,5890,5973,0
2020-03-25,NM,100,6742,6842,1
2020-03-26,NM,112,7681,7793,1
2020-03-27,NM,136,8377,8513,1
2020-03-28,NM,191,9196,9387,1
2020-03-29,NM,237,10769,11006,2
2020-03-30,NM,237,10942,11179,2
2020-03-31,NM,281,12246,12527,4
2020-04-01,NM,315,12925,13240,5
2020-04-02,NM,363,13648,14011,6
2020-04-03,NM,403,14375,14778,7
2020-04-04,NM,495,15137,15632,10
2020-04-05,NM,543,16285,16828,11
2020-04-06,NM,624,18512,19136,12
2020-04-07,NM,686,21139,21825,12
2020-04-08,NM,794,21451,22245,13
2020-04-09,NM,865,22942,23807,16
2020-04-10,NM,1091,26007,27098,19
2020-04-11,NM,1091,26007,27098,19
2020-04-12,NM,1174,27518,28692,20
2020-04-13,NM,1245,29270,30515,26
2020-04-14,NM,1345,30625,31970,31
2020-04-15,NM,1407,31443,32850,36
2020-04-16,NM,1484,31910,33394,36
2020-04-17,NM,1597,32891,34488,44
2020-04-18,NM,1711,33902,35613,51
2020-04-19,NM,1798,34834,36632,53
2020-04-20,NM,1845,35197,37042,55
2020-04-21,NM,1971,36784,38755,58
2020-04-22,NM,2072,38805,40877,65
2020-04-23,NM,2210,39022,41232,71
2020-04-24,NM,2379,44184,46563,78
2020-04-25,NM,2521,48989,51510,84
2020-04-26,NM,2660,51075,53735,93
2020-04-27,NM,2726,53889,56615,99
2020-04-28,NM,2823,55980,58803,104
2020-04-29,NM,2974,58771,61745,110
2020-04-30,NM,3213,61872,65085,112
2020-05-01,NM,3411,64458,67869,123
2020-05-02,NM,3513,67605,71118,131
2020-05-03,NM,3732,71212,74944,139
2020-05-04,NM,3850,74127,77977,151
2020-05-05,NM,4031,77689,81720,156
2020-05-06,NM,4138,79113,83251,162
2020-05-07,NM,4291,81393,85684,169
2020-05-08,NM,4493,84539,89032,172
2020-05-09,NM,4673,88589,93262,181
2020-05-10,NM,4778,92275,97053,191
2020-05-11,NM,4863,97635,102498,200
2020-05-12,NM,5069,101652,106721,208
2020-05-13,NM,5212,105077,110289,219
2020-05-14,NM,5364,109647,115011,231
2020-05-15,NM,5503,114098,119601,242
2020-05-16,NM,5662,118796,124458,253
2020-05-17,NM,5857,122727,128584,259
2020-05-18,NM,5938,127315,133253,265
2020-05-19,NM,6096,131524,137620,270
2020-05-20,NM,6192,136054,142246,276
2020-05-21,NM,6317,141027,147344,283
2020-05-22,NM,6472,146295,152767,294
2020-05-23,NM,6625,151758,158383,302
2020-05-24,NM,6795,162324,169119,308
2020-05-25,NM,6943,166538,173481,317
2020-05-26,NM,7026,170335,177361,320
2020-05-27,NM,7130,173516,180646,325
2020-05-28,NM,7252,172291,179543,329
2020-05-29,NM,7364,176180,183544,335
2020-05-30,NM,7493,180768,188261,344
2020-05-31,NM,7624,186823,194447,351
2020-06-01,NM,7689,191915,199604,356
2020-06-02,NM,7800,195315,203115,362
2020-06-03,NM,8024,198813,206837,367
2020-06-04,NM,8140,204856,212996,375
2020-06-05,NM,8353,209404,217757,383
2020-06-06,NM,8672,215968,224640,387
2020-06-07,NM,8800,220347,229147,392
2020-06-08,NM,8940,225435,234375,396
2020-06-09,NM,9062,229739,238801,400
2020-06-10,NM,9105,232552,241657,404
2020-06-11,NM,9250,236307,245557,410
2020-06-12,NM,9526,245758,255284,426
2020-06-13,NM,9526,245758,255284,426
2020-06-14,NM,9621,249373,258994,431
2020-06-15,NM,9723,253942,263665,435
2020-06-16,NM,9845,258076,267921,440
2020-06-17,NM,9933,261620,271553,447
2020-06-18,NM,10065,265832,275897,452
2020-06-19,NM,10153,270022,280175,456
2020-06-20,NM,10260,274342,284602,464
2020-06-21,NM,10565,282866,293431,469
2020-06-22,NM,10565,282866,293431,469
2020-06-23,NM,10694,287382,298076,469
2020-06-24,NM,10838,291245,302083,476
2020-06-25,NM,10990,297115,308105,480
2020-06-26,NM,11192,303478,314670,485
2020-06-27,NM,11408,309230,320638,489
2020-06-28,NM,11619,311340,322959,491
2020-06-29,NM,11809,319239,331048,492
2020-06-30,NM,11982,325738,337720,493
2020-07-01,NM,12147,332034,344181,497
2020-07-02,NM,12276,337784,350060,500
2020-07-03,NM,12520,344117,356637,503
2020-07-04,NM,12776,350598,363374,511
2020-07-05,NM,13063,359225,372288,513
2020-07-06,NM,13256,361798,375054,513
2020-07-07,NM,13507,366733,380240,515
2020-07-08,NM,13727,371515,385242,519
2020-07-09,NM,14017,375670,389687,527
2020-07-10,NM,14251,381630,395881,533
2020-07-11,NM,14549,389032,403581,539
2020-07-12,NM,14773,395981,410754,543
2020-07-13,NM,15028,403329,418357,545
2020-07-14,NM,15291,409064,424355,548
2020-07-15,NM,15514,414492,430006,551
2020-07-16,NM,15841,421164,437005,557
2020-07-17,NM,16138,427230,443368,562
2020-07-18,NM,16456,435842,452298,565
2020-07-19,NM,16736,443928,460664,569
2020-07-20,NM,16971,452244,469215,571
2020-07-21,NM,17215,459282,476497,578
2020-07-22,NM,17517,464014,481531,588
2020-07-23,NM,17828,471506,489334,591
2020-07-24,NM,18163,478822,496985,596
2020-07-25,NM,18475,486702,505177,601
2020-03-05,NV,1,14,15,0
2020-03-06,NV,1,14,15,0
2020-03-07,NV,1,14,15,0
2020-03-08,NV,1,14,15,0
2020-03-09,NV,1,14,15,0
2020-03-10,NV,1,14,15,0
2020-03-11,NV,5,168,173,0
2020-03-12,NV,7,168,175,0
2020-03-13,NV,11,168,179,0
2020-03-14,NV,20,168,188,0
2020-03-15,NV,21,168,189,1
2020-03-16,NV,45,168,213,1
2020-03-17,NV,55,168,223,1
2020-03-18,NV,55,168,223,2
2020-03-19,NV,95,1626,1721,3
2020-03-20,NV,109,1992,2101,3
2020-03-21,NV,124,2384,2508,5
2020-03-22,NV,190,2448,2638,7
2020-03-23,NV,245,3490,3735,8
2020-03-24,NV,278,3954,4232,13
2020-03-25,NV,321,4251,4572,13
2020-03-26,NV,420,4697,5117,17
2020-03-27,NV,535,6161,6696,21
2020-03-28,NV,621,7901,8522,25
2020-03-29,NV,738,8412,9150,28
2020-03-30,NV,1008,10207,11215,32
2020-03-31,NV,1113,10681,11794,37
2020-04-01,NV,1279,11519,12798,45
2020-04-02,NV,1458,12588,14046,51
2020-04-03,NV,1514,13018,14532,59
2020-04-04,NV,1742,14421,16163,70
2020-04-05,NV,1836,14995,16831,76
2020-04-06,NV,1953,15676,17629,79
2020-04-07,NV,2087,16552,18639,91
2020-04-08,NV,2318,18248,20566,101
2020-04-09,NV,2456,19315,21771,110
2020-04-10,NV,2584,20165,22749,120
2020-04-11,NV,2700,20887,23587,125
2020-04-12,NV,2836,21775,24611,128
2020-04-13,NV,2971,22493,25464,133
2020-04-14,NV,3088,23573,26661,141
2020-04-15,NV,3211,24444,27655,150
2020-04-16,NV,3321,25130,28451,158
2020-04-17,NV,3524,26238,29762,162
2020-04-18,NV,3626,27125,30751,168
2020-04-19,NV,3728,27870,31598,172
2020-04-20,NV,3830,28517,32347,180
2020-04-21,NV,3937,29118,33055,193
2020-04-22,NV,4081,29807,33888,201
2020-04-23,NV,4208,30541,34749,210
2020-04-24,NV,4398,31794,36192,216
2020-04-25,NV,4539,32669,37208,229
2020-04-26,NV,4602,33584,38186,235
2020-04-27,NV,4690,34123,38813,245
2020-04-28,NV,4805,35314,40119,251
2020-04-29,NV,4898,36130,41028,257
2020-04-30,NV,4998,36988,41986,269
2020-05-01,NV,5227,38368,43595,277
2020-05-02,NV,5311,39076,44387,281
2020-05-03,NV,5426,39843,45269,287
2020-05-04,NV,5491,40675,46166,292
2020-05-05,NV,5594,42290,47884,297
2020-05-06,NV,5663,43612,49275,311
2020-05-07,NV,5766,45591,51357,320
2020-05-08,NV,5884,47460,53344,328
2020-05-09,NV,6028,50083,56111,334
2020-05-10,NV,6098,52711,58809,339
2020-05-11,NV,6152,53932,60084,344
2020-05-12,NV,6311,57764,64075,350
2020-05-13,NV,6394,60278,66672,355
2020-05-14,NV,6499,62985,69484,358
2020-05-15,NV,6614,65532,72146,368
2020-05-16,NV,6662,67002,73664,369
2020-05-17,NV,6857,73780,80637,375
2020-05-18,NV,6906,74926,81832,383
2020-05-19,NV,7046,80509,87555,390
2020-05-20,NV,7166,84005,91171,393
2020-05-21,NV,7255,87127,94382,397
2020-05-22,NV,7401,92540,99941,400
2020-05-23,NV,7696,99351,107047,404
2020-05-24,NV,7770,102511,110281,408
2020-05-25,NV,7879,106852,114731,410
2020-05-26,NV,7997,115370,123367,412
2020-05-27,NV,8113,120446,128559,416
2020-05-28,NV,8208,122982,131190,425
2020-05-29,NV,8350,126066,134416,435
2020-05-30,NV,8495,130037,138532,439
2020-05-31,NV,8593,133967,142560,444
2020-06-01,NV,8688,138095,146783,445
2020-06-02,NV,8830,143261,152091,452
2020-06-03,NV,8935,147320,156255,455
2020-06-04,NV,9090,152333,161423,460
2020-06-05,NV,9266,156841,166107,460
2020-06-06,NV,9460,162311,171771,463
2020-06-07,NV,9649,166048,175697,465
2020-06-08,NV,9786,170217,180003,469
2020-06-09,NV,10030,173559,183589,472
2020-06-10,NV,10164,177159,187323,474
2020-06-11,NV,10399,182855,193254,475
2020-06-12,NV,10678,188769,199447,475
2020-06-13,NV,10946,193934,204880,478
2020-06-14,NV,11173,199438,210611,479
2020-06-15,NV,11279,205155,216434,483
2020-06-16,NV,11658,210816,222474,485
2020-06-17,NV,11842,215768,227610,486
2020-06-18,NV,12076,218720,230796,489
2020-06-19,NV,12486,221874,234360,491
2020-06-20,NV,12931,226032,238963,491
2020-06-21,NV,13205,228486,241691,492
2020-06-22,NV,13535,230530,244065,492
2020-06-23,NV,13997,234529,248526,492
2020-06-24,NV,14362,238025,252387,494
2020-06-25,NV,14859,240691,255550,495
2020-06-26,NV,15240,243422,258662,498
2020-06-27,NV,16339,246687,263026,500
2020-06-28,NV,17160,250420,267580,500
2020-06-29,NV,17894,255123,273017,504
2020-06-30,NV,18456,259112,277568,507
2020-07-01,NV,19101,264995,284096,511
2020-07-02,NV,19733,264995,284728,525
2020-07-03,NV,20718,272967,293685,528
2020-07-04,NV,21575,279654,301229,530
2020-07-05,NV,22418,285279,307697,534
2020-07-06,NV,22909,288572,311481,537
2020-07-07,NV,23785,292761,316546,548
2020-07-08,NV,24301,299352,323653,553
2020-07-09,NV,24904,304874,329778,571
2020-07-10,NV,25908,309583,335491,579
2020-07-11,NV,26838,314395,341233,592
2020-07-12,NV,27683,319873,347556,593
2020-07-13,NV,28515,324678,353193,593
2020-07-14,NV,29619,330561,360180,612
2020-07-15,NV,30468,333957,364425,618
2020-07-16,NV,31915,338928,370843,626
2020-07-17,NV,33295,343712,377007,637
2020-07-18,NV,34477,348060,382537,646
2020-07-19,NV,35765,354023,389788,647
2020-07-20,NV,36713,358708,395421,648
2020-07-21,NV,37528,361294,398822,676
2020-07-22,NV,38657,365651,404308,704
2020-07-23,NV,39919,374217,414136,709
2020-07-24,NV,40885,380986,421871,722
2020-07-25,NV,41816,388705,430521,732
2020-03-04,NY,6,48,54,0
2020-03-05,NY,22,76,98,0
2020-03-06,NY,33,92,125,0
2020-03-07,NY,76,92,168,0
2020-03-08,NY,105,92,197,0
2020-03-09,NY,142,92,234,0
2020-03-10,NY,173,92,265,0
2020-03-11,NY,216,92,308,0
2020-03-12,NY,216,92,308,0
2020-03-13,NY,421,2779,3200,0
2020-03-14,NY,524,2779,3303,0
2020-03-15,NY,729,4543,5272,3
2020-03-16,NY,950,4543,5493,7
2020-03-17,NY,1700,5506,7206,7
2020-03-18,NY,2382,12215,14597,12
2020-03-19,NY,4152,18132,22284,12
2020-03-20,NY,7102,25325,32427,35
2020-03-21,NY,10356,35081,45437,44
2020-03-22,NY,15168,46233,61401,114
2020-03-23,NY,20875,57414,78289,114
2020-03-24,NY,25665,65605,91270,210
2020-03-25,NY,30811,72668,103479,285
2020-03-26,NY,37258,84846,122104,385
2020-03-27,NY,44635,101118,145753,519
2020-03-28,NY,52318,103616,155934,728
2020-03-29,NY,59513,112847,172360,965
2020-03-30,NY,66497,119971,186468,1218
2020-03-31,NY,75795,129391,205186,1550
2020-04-01,NY,83712,137168,220880,1941
2020-04-02,NY,92381,146584,238965,2373
2020-04-03,NY,102863,157657,260520,2935
2020-04-04,NY,113704,169917,283621,3565
2020-04-05,NY,122031,180249,302280,4159
2020-04-06,NY,130689,190122,320811,4758
2020-04-07,NY,138863,201195,340058,5489
2020-04-08,NY,149316,215837,365153,6268
2020-04-09,NY,159937,231612,391549,7067
2020-04-10,NY,170512,247373,417885,7844
2020-04-11,NY,180458,260522,440980,8627
2020-04-12,NY,188694,272907,461601,9385
2020-04-13,NY,195031,283326,478357,10056
2020-04-14,NY,202208,296935,499143,10834
2020-04-15,NY,213779,312233,526012,11586
2020-04-16,NY,222284,328295,550579,12192
2020-04-17,NY,229642,343581,573223,12822
2020-04-18,NY,236732,359800,596532,13362
2020-04-19,NY,242786,374769,617555,13869
2020-04-20,NY,247512,386349,633861,14347
2020-04-21,NY,251690,397635,649325,14828
2020-04-22,NY,257216,412766,669982,15302
2020-04-23,NY,263460,432460,695920,15740
2020-04-24,NY,271590,459066,730656,16162
2020-04-25,NY,282143,495425,777568,16599
2020-04-26,NY,288045,517305,805350,16966
2020-04-27,NY,291996,534099,826095,17303
2020-04-28,NY,295106,549888,844994,17638
2020-04-29,NY,299691,572790,872481,18015
2020-04-30,NY,304372,596264,900636,18321
2020-05-01,NY,308314,619124,927438,18610
2020-05-02,NY,312977,646094,959071,18909
2020-05-03,NY,316415,669496,985911,19189
2020-05-04,NY,318953,688357,1007310,19415
2020-05-05,NY,321192,707707,1028899,19645
2020-05-06,NY,323978,731943,1055921,19877
2020-05-07,NY,327649,762267,1089916,20828
2020-05-08,NY,330407,791136,1121543,21045
2020-05-09,NY,333122,820646,1153768,21271
2020-05-10,NY,335395,847603,1182998,21478
2020-05-11,NY,337055,867596,1204651,21640
2020-05-12,NY,338485,886628,1225113,21845
2020-05-13,NY,340661,918246,1258907,22013
2020-05-14,NY,343051,955706,1298757,22170
2020-05-15,NY,345813,992235,1338048,22304
2020-05-16,NY,348232,1030485,1378717,22478
2020-05-17,NY,350121,1063275,1413396,22619
2020-05-18,NY,351371,1088186,1439557,22729
2020-05-19,NY,352845,1114894,1467739,22843
2020-05-20,NY,354370,1151466,1505836,22976
2020-05-21,NY,356458,1198597,1555055,23083
2020-05-22,NY,358154,1242639,1600793,23195
2020-05-23,NY,359926,1292135,1652061,23282
2020-05-24,NY,361515,1338311,1699826,23391
2020-05-25,NY,362764,1376685,1739449,23488
2020-05-26,NY,363836,1410292,1774128,23564
2020-05-27,NY,364965,1446579,1811544,23643
2020-05-28,NY,366733,1510056,1876789,23722
2020-05-29,NY,368284,1575846,1944130,23780
2020-05-30,NY,369660,1635721,2005381,23848
2020-05-31,NY,370770,1693055,2063825,23905
2020-06-01,NY,371711,1742066,2113777,23959
2020-06-02,NY,373040,1794791,2167831,24023
2020-06-03,NY,374085,1855388,2229473,24079
2020-06-04,NY,375133,1917899,2293032,24133
2020-06-05,NY,376208,1983304,2359512,24175
2020-06-06,NY,377316,2060091,2437407,24212
2020-06-07,NY,378097,2119745,2497842,24259
2020-06-08,NY,378799,2177097,2555896,24299
2020-06-09,NY,379482,2226387,2605869,24348
2020-06-10,NY,380156,2288010,2668166,24404
2020-06-11,NY,380892,2348113,2729005,24442
2020-06-12,NY,381714,2419686,2801400,24495
2020-06-13,NY,382630,2489610,2872240,24527
2020-06-14,NY,383324,2551275,2934599,24551
2020-06-15,NY,383944,2607266,2991210,24579
2020-06-16,NY,384575,2667203,3051778,24608
2020-06-17,NY,385142,2725977,3111119,24629
2020-06-18,NY,385760,2793900,3179660,24661
2020-06-19,NY,386556,2872407,3258963,24686
2020-06-20,NY,387272,2940521,3327793,24710
2020-06-21,NY,387936,3007383,3395319,24725
2020-06-22,NY,388488,3063611,3452099,24739
2020-06-23,NY,389085,3111723,3500808,24766
2020-06-24,NY,389666,3162286,3551952,24782
2020-06-25,NY,390415,3229179,3619594,24800
2020-06-26,NY,391220,3290097,3681317,24814
2020-06-27,NY,391923,3362656,3754579,24830
2020-06-28,NY,392539,3423946,3816485,24835
2020-06-29,NY,392930,3469983,3862913,24842
2020-06-30,NY,393454,3521484,3914938,24855
2020-07-01,NY,394079,3577569,3971648,24866
2020-07-02,NY,394954,3646639,4041593,24877
2020-07-03,NY,395872,3712113,4107985,24885
2020-07-04,NY,396598,3773790,4170388,24896
2020-07-05,NY,397131,3836672,4233803,24904
2020-07-06,NY,397649,3890482,4288131,24913
2020-07-07,NY,398237,3946630,4344867,24924
2020-07-08,NY,398929,4003523,4402452,24944
2020-07-09,NY,399513,4068503,4468016,24959
2020-07-10,NY,400299,4141275,4541574,24968
2020-07-11,NY,401029,4209748,4610777,24974
2020-07-12,NY,401706,4271489,4673195,24979
2020-07-13,NY,402263,4322619,4724882,24989
2020-07-14,NY,403175,4381752,4784927,24994
2020-07-15,NY,404006,4444519,4848525,25003
2020-07-16,NY,404775,4516435,4921210,25014
2020-07-17,NY,405551,4593898,4999449,25024
2020-07-18,NY,406305,4662961,5069266,25035
2020-07-19,NY,406807,4708663,5115470,25048
2020-07-20,NY,407326,4757486,5164812,25056
2020-07-21,NY,408181,4822800,5230981,25058
2020-07-22,NY,408886,4889754,5298640,25068
2020-07-23,NY,409697,4958641,5368338,25081
2020-07-24,NY,410450,5034395,5444845,25090
2020-07-25,NY,411200,5105111,5516311,25103
2020-03-05,OH,0,7,7,0
2020-03-06,OH,0,8,8,0
2020-03-07,OH,0,9,9,0
2020-03-08,OH,0,10,10,0
2020-03-09,OH,3,11,14,0
2020-03-10,OH,3,14,17,0
2020-03-11,OH,4,21,25,0
2020-03-12,OH,5,30,35,0
2020-03-13,OH,13,50,63,0
2020-03-14,OH,13,50,63,0
2020-03-15,OH,36,139,175,0
2020-03-16,OH,50,140,190,0
2020-03-17,OH,67,140,207,0
2020-03-18,OH,88,140,228,0
2020-03-19,OH,119,140,259,0
2020-03-20,OH,169,140,309,1
2020-03-21,OH,247,140,387,3
2020-03-22,OH,351,140,491,3
2020-03-23,OH,442,140,582,6
2020-03-24,OH,564,140,704,8
2020-03-25,OH,704,14060,14764,10
2020-03-26,OH,867,16449,17316,15
2020-03-27,OH,1137,19012,20149,19
2020-03-28,OH,1406,19012,20418,25
2020-03-29,OH,1653,19012,20665,29
2020-03-30,OH,1933,25342,27275,39
2020-03-31,OH,2199,26992,29191,55
2020-04-01,OH,2547,26992,29539,65
2020-04-02,OH,2902,32016,34918,81
2020-04-03,OH,3312,35063,38375,91
2020-04-04,OH,3739,38132,41871,102
2020-04-05,OH,4043,39713,43756,119
2020-04-06,OH,4450,43928,48378,142
2020-04-07,OH,4782,46056,50838,167
2020-04-08,OH,5148,48193,53341,193
2020-04-09,OH,5512,50473,55985,213
2020-04-10,OH,5878,52695,58573,231
2020-04-11,OH,6250,54221,60471,247
2020-04-12,OH,6604,56639,63243,253
2020-04-13,OH,6975,58137,65112,274
2020-04-14,OH,7280,60721,68001,324
2020-04-15,OH,7791,63761,71552,361
2020-04-16,OH,8414,66426,74840,389
2020-04-17,OH,9107,68819,77926,418
2020-04-18,OH,10222,68819,79041,451
2020-04-19,OH,11602,75697,87299,471
2020-04-20,OH,12919,77920,90839,509
2020-04-21,OH,13725,80989,94714,557
2020-04-22,OH,14117,84389,98506,610
2020-04-23,OH,14694,88183,102877,656
2020-04-24,OH,15169,92528,107697,690
2020-04-25,OH,15587,96396,111983,711
2020-04-26,OH,15963,100423,116386,728
2020-04-27,OH,16325,103692,120017,753
2020-04-28,OH,16769,106578,123347,799
2020-04-29,OH,17303,111605,128908,937
2020-04-30,OH,18027,115863,133890,975
2020-05-01,OH,18743,121763,140506,1002
2020-05-02,OH,19335,126484,145819,1021
2020-05-03,OH,19914,130252,150166,1038
2020-05-04,OH,20474,134681,155155,1056
2020-05-05,OH,20969,139766,160735,1135
2020-05-06,OH,21576,147353,168929,1225
2020-05-07,OH,22131,153928,176059,1271
2020-05-08,OH,23016,161300,184316,1306
2020-05-09,OH,23697,172973,196670,1331
2020-05-10,OH,24081,180781,204862,1341
2020-05-11,OH,24777,185753,210530,1357
2020-05-12,OH,25250,192481,217731,1436
2020-05-13,OH,25721,200133,225854,1483
2020-05-14,OH,26357,206995,233352,1534
2020-05-15,OH,26954,219228,246182,1581
2020-05-16,OH,27474,219228,246702,1610
2020-05-17,OH,27923,236539,264462,1625
2020-05-18,OH,28454,243395,271849,1657
2020-05-19,OH,28952,248650,277602,1720
2020-05-20,OH,29436,260092,289528,1781
2020-05-21,OH,30167,268911,299078,1836
2020-05-22,OH,30794,277006,307800,1872
2020-05-23,OH,31408,285086,316494,1956
2020-05-24,OH,31911,292642,324553,1969
2020-05-25,OH,32477,297857,330334,1987
2020-05-26,OH,33006,306394,339400,2002
2020-05-27,OH,33439,316286,349725,2044
2020-05-28,OH,33915,326097,360012,2098
2020-05-29,OH,34566,335324,369890,2131
2020-05-30,OH,35034,346913,381947,2149
2020-05-31,OH,35513,355395,390908,2155
2020-06-01,OH,35984,362082,398066,2206
2020-06-02,OH,36350,373558,409908,2258
2020-06-03,OH,36792,389313,426105,2299
2020-06-04,OH,37282,399969,437251,2339
2020-06-05,OH,37758,408437,446195,2355
2020-06-06,OH,38111,420415,458526,2370
2020-06-07,OH,38476,430548,469024,2377
2020-06-08,OH,38837,437981,476818,2404
2020-06-09,OH,39162,451228,490390,2421
2020-06-10,OH,39575,462309,501884,2457
2020-06-11,OH,40004,472579,512583,2490
2020-06-12,OH,40424,483294,523718,2508
2020-06-13,OH,40848,498050,538898,2554
2020-06-14,OH,41148,505072,546220,2557
2020-06-15,OH,41576,515592,557168,2573
2020-06-16,OH,42010,526123,568133,2597
2020-06-17,OH,42422,542141,584563,2611
2020-06-18,OH,43122,556902,600024,2633
2020-06-19,OH,43731,572305,616036,2667
2020-06-20,OH,44262,585703,629965,2697
2020-06-21,OH,44808,598413,643221,2700
2020-06-22,OH,45537,614064,659601,2704
2020-06-23,OH,46127,624310,670437,2735
2020-06-24,OH,46759,633928,680687,2755
2020-06-25,OH,47651,651979,699630,2772
2020-06-26,OH,48638,672914,721552,2788
2020-06-27,OH,49455,695384,744839,2804
2020-06-28,OH,50309,706456,756765,2807
2020-06-29,OH,51046,723336,774382,2818
2020-06-30,OH,51789,736140,787929,2863
2020-07-01,OH,52865,739140,792005,2876
2020-07-02,OH,54166,739140,793306,2903
2020-07-03,OH,55257,772900,828157,2903
2020-07-04,OH,56183,792187,848370,2907
2020-07-05,OH,57151,811611,868762,2911
2020-07-06,OH,57956,823456,881412,2927
2020-07-07,OH,58904,837581,896485,2970
2020-07-08,OH,60181,855071,915252,2991
2020-07-09,OH,61331,855071,916402,3006
2020-07-10,OH,62856,896697,959553,3032
2020-07-11,OH,64214,918821,983035,3036
2020-07-12,OH,65592,940794,1006386,3058
2020-07-13,OH,66853,957898,1024751,3064
2020-07-14,OH,67995,975754,1043749,3069
2020-07-15,OH,69311,993312,1062623,3075
2020-07-16,OH,70601,1018192,1088793,3103
2020-07-17,OH,72280,1043844,1116124,3112
2020-07-18,OH,73822,1064614,1138436,3132
2020-07-19,OH,74932,1087982,1162914,3174
2020-07-20,OH,76168,1105744,1181912,3189
2020-07-21,OH,77215,1122808,1200023,3219
2020-07-22,OH,78742,1142853,1221595,3235
2020-07-23,OH,80186,1164840,1245026,3256
2020-07-24,OH,81746,1185882,1267628,3297
2020-07-25,OH,83184,1210638,1293822,3297
2020-03-07,OK,1,0,1,0
2020-03-08,OK,1,8,9,0
2020-03-09,OK,1,8,9,0
2020-03-10,OK,2,15,17,0
2020-03-11,OK,2,15,17,0
2020-03-12,OK,3,36,39,0
2020-03-13,OK,3,36,39,0
2020-03-14,OK,4,36,40,0
2020-03-15,OK,9,118,127,0
2020-03-16,OK,10,174,184,0
2020-03-17,OK,17,247,264,0
2020-03-18,OK,29,378,407,0
2020-03-19,OK,44,466,510,1
2020-03-20,OK,49,538,587,1
2020-03-21,OK,53,560,613,1
2020-03-22,OK,67,669,736,2
2020-03-23,OK,81,694,775,2
2020-03-24,OK,106,735,841,3
2020-03-25,OK,164,805,969,5
2020-03-26,OK,248,958,1206,7
2020-03-27,OK,322,1084,1406,8
2020-03-28,OK,377,1180,1557,15
2020-03-29,OK,429,1205,1634,16
2020-03-30,OK,481,1207,1688,17
2020-03-31,OK,565,1229,1794,23
2020-04-01,OK,719,1248,1967,30
2020-04-02,OK,879,1265,2144,34
2020-04-03,OK,988,1315,2303,38
2020-04-04,OK,1159,1362,2521,42
2020-04-05,OK,1252,1401,2653,46
2020-04-06,OK,1327,1422,2749,51
2020-04-07,OK,1472,11821,13293,67
2020-04-08,OK,1524,11821,13345,79
2020-04-09,OK,1684,18595,20279,80
2020-04-10,OK,1794,20370,22164,88
2020-04-11,OK,1868,20790,22658,94
2020-04-12,OK,1970,20790,22760,96
2020-04-13,OK,2069,20790,22859,99
2020-04-14,OK,2184,26085,28269,108
2020-04-15,OK,2263,26956,29219,123
2020-04-16,OK,2357,28542,30899,131
2020-04-17,OK,2465,31155,33620,136
2020-04-18,OK,2570,32966,35536,139
2020-04-19,OK,2599,32966,35565,140
2020-04-20,OK,2680,32966,35646,143
2020-04-21,OK,2807,41537,44344,164
2020-04-22,OK,2894,43019,45913,170
2020-04-23,OK,3017,43019,46036,179
2020-04-24,OK,3121,43019,46140,188
2020-04-25,OK,3193,49891,53084,194
2020-04-26,OK,3253,49891,53144,195
2020-04-27,OK,3280,49891,53171,197
2020-04-28,OK,3410,56289,59699,207
2020-04-29,OK,3473,57794,61267,214
2020-04-30,OK,3618,59804,63422,222
2020-05-01,OK,3748,59804,63552,230
2020-05-02,OK,3851,59804,63655,238
2020-05-03,OK,3972,59804,63776,238
2020-05-04,OK,4044,59804,63848,238
2020-05-05,OK,4127,75290,79417,247
2020-05-06,OK,4201,78689,82890,253
2020-05-07,OK,4330,82557,86887,260
2020-05-08,OK,4424,85433,89857,266
2020-05-09,OK,4490,91379,95869,270
2020-05-10,OK,4589,91379,95968,272
2020-05-11,OK,4613,91379,95992,274
2020-05-12,OK,4732,91379,96111,278
2020-05-13,OK,4852,104275,109127,278
2020-05-14,OK,4962,107221,112183,284
2020-05-15,OK,5086,113106,118192,285
2020-05-16,OK,5237,118162,123399,288
2020-05-17,OK,5310,118162,123472,288
2020-05-18,OK,5398,118162,123560,288
2020-05-19,OK,5489,133658,139147,294
2020-05-20,OK,5532,138839,144371,299
2020-05-21,OK,5680,143915,149595,304
2020-05-22,OK,5849,147318,153167,307
2020-05-23,OK,5960,154943,160903,311
2020-05-24,OK,6037,154943,160980,311
2020-05-25,OK,6090,154943,161033,313
2020-05-26,OK,6137,153804,159941,318
2020-05-27,OK,6229,172409,178638,322
2020-05-28,OK,6270,176136,182406,326
2020-05-29,OK,6338,181060,187398,329
2020-05-30,OK,6418,186700,193118,334
2020-05-31,OK,6506,186700,193206,334
2020-06-01,OK,6573,186700,193273,334
2020-06-02,OK,6692,197965,204657,339
2020-06-03,OK,6805,201247,208052,341
2020-06-04,OK,6907,204815,211722,344
2020-06-05,OK,6907,209564,216471,344
2020-06-06,OK,7003,214598,221601,345
2020-06-07,OK,7150,214598,221748,348
2020-06-08,OK,7205,214598,221803,348
2020-06-09,OK,7363,226678,234041,353
2020-06-10,OK,7480,229817,237297,355
2020-06-11,OK,7626,233819,241445,357
2020-06-12,OK,7848,238366,246214,359
2020-06-13,OK,8073,238366,246439,359
2020-06-14,OK,8231,242587,250818,359
2020-06-15,OK,8417,242587,251004,359
2020-06-16,OK,8645,253160,261805,363
2020-06-17,OK,8904,256528,265432,364
2020-06-18,OK,9354,260199,269553,366
2020-06-19,OK,9706,264872,274578,367
2020-06-20,OK,10037,271925,281962,368
2020-06-21,OK,10515,271925,282440,369
2020-06-22,OK,10733,271925,282658,369
2020-06-23,OK,11028,284029,295057,371
2020-06-24,OK,11510,286768,298278,372
2020-06-25,OK,11948,293017,304965,375
2020-06-26,OK,12343,298434,310777,377
2020-06-27,OK,12642,313021,325663,384
2020-06-28,OK,12944,313021,325965,385
2020-06-29,OK,13172,313021,326193,385
2020-06-30,OK,13757,327840,341597,387
2020-07-01,OK,14112,332201,346313,389
2020-07-02,OK,14539,338511,353050,395
2020-07-03,OK,15065,348789,363854,398
2020-07-04,OK,15645,348789,364434,398
2020-07-05,OK,15928,348789,364717,398
2020-07-06,OK,16362,348789,365151,399
2020-07-07,OK,17220,371798,389018,404
2020-07-08,OK,17893,376930,394823,407
2020-07-09,OK,18496,383258,401754,410
2020-07-10,OK,19092,391982,411074,416
2020-07-11,OK,19779,400037,419816,421
2020-07-12,OK,20235,400037,420272,422
2020-07-13,OK,20745,400037,420782,424
2020-07-14,OK,21738,419556,441294,428
2020-07-15,OK,22813,424512,447325,432
2020-07-16,OK,23441,433376,456817,438
2020-07-17,OK,24140,440904,465044,445
2020-07-18,OK,25056,450675,475731,451
2020-07-19,OK,25265,450675,475940,451
2020-07-20,OK,25433,450675,476108,452
2020-07-21,OK,26326,472057,498383,461
2020-07-22,OK,27301,478297,505598,474
2020-07-23,OK,27969,485206,513175,477
2020-07-24,OK,29116,493926,523042,484
2020-07-25,OK,30081,535628,565709,496
2020-03-04,OR,3,29,32,0
2020-03-05,OR,3,45,48,0
2020-03-06,OR,3,64,67,0
2020-03-07,OR,7,77,84,0
2020-03-08,OR,14,100,114,0
2020-03-09,OR,14,165,179,0
2020-03-10,OR,15,213,228,0
2020-03-11,OR,19,286,305,0
2020-03-12,OR,19,286,305,0
2020-03-13,OR,30,337,367,0
2020-03-14,OR,30,337,367,0
2020-03-15,OR,36,420,456,0
2020-03-16,OR,39,579,618,0
2020-03-17,OR,47,689,736,0
2020-03-18,OR,75,1118,1193,3
2020-03-19,OR,88,1329,1417,3
2020-03-20,OR,114,2003,2117,3
2020-03-21,OR,114,2003,2117,3
2020-03-22,OR,161,2864,3025,4
2020-03-23,OR,191,3649,3840,5
2020-03-24,OR,209,4350,4559,8
2020-03-25,OR,209,4350,4559,8
2020-03-26,OR,327,6953,7280,11
2020-03-27,OR,414,8510,8924,12
2020-03-28,OR,479,9693,10172,13
2020-03-29,OR,548,10878,11426,13
2020-03-30,OR,606,12277,12883,16
2020-03-31,OR,690,13136,13826,18
2020-04-01,OR,736,13136,13872,18
2020-04-02,OR,826,15259,16085,21
2020-04-03,OR,899,16535,17434,22
2020-04-04,OR,999,16535,17534,26
2020-04-05,OR,1068,19556,20624,27
2020-04-06,OR,1132,20669,21801,27
2020-04-07,OR,1181,21826,23007,33
2020-04-08,OR,1239,23325,24564,33
2020-04-09,OR,1321,24306,25627,44
2020-04-10,OR,1321,24306,25627,44
2020-04-11,OR,1371,25853,27224,48
2020-04-12,OR,1527,28231,29758,52
2020-04-13,OR,1584,29537,31121,53
2020-04-14,OR,1633,30730,32363,55
2020-04-15,OR,1663,31688,33351,58
2020-04-16,OR,1736,33202,34938,64
2020-04-17,OR,1785,34536,36321,70
2020-04-18,OR,1844,35739,37583,72
2020-04-19,OR,1910,37128,39038,74
2020-04-20,OR,1956,38089,40045,75
2020-04-21,OR,2002,39126,41128,78
2020-04-22,OR,2059,39126,41185,78
2020-04-23,OR,2127,41849,43976,83
2020-04-24,OR,2177,43315,45492,86
2020-04-25,OR,2253,45124,47377,87
2020-04-26,OR,2311,46653,48964,91
2020-04-27,OR,2354,48844,51198,92
2020-04-28,OR,2354,48844,51198,92
2020-04-29,OR,2446,52026,54472,101
2020-04-30,OR,2510,53522,56032,103
2020-05-01,OR,2579,55597,58176,104
2020-05-02,OR,2635,57501,60136,109
2020-05-03,OR,2680,59374,62054,109
2020-05-04,OR,2759,60698,63457,109
2020-05-05,OR,2839,62585,65424,113
2020-05-06,OR,2916,65060,67976,115
2020-05-07,OR,2989,67469,70458,121
2020-05-08,OR,3068,69625,72693,124
2020-05-09,OR,3160,71460,74620,127
2020-05-10,OR,3228,72279,75507,127
2020-05-11,OR,3286,74320,77606,130
2020-05-12,OR,3286,74320,77606,130
2020-05-13,OR,3416,80571,83987,134
2020-05-14,OR,3479,80571,84050,137
2020-05-15,OR,3541,85965,89506,137
2020-05-16,OR,3612,88587,92199,137
2020-05-17,OR,3623,90733,94356,137
2020-05-18,OR,3687,93628,97315,138
2020-05-19,OR,3726,95994,99720,140
2020-05-20,OR,3801,98348,102149,144
2020-05-21,OR,3817,101407,105224,145
2020-05-22,OR,3864,103975,107839,147
2020-05-23,OR,3888,106319,110207,147
2020-05-24,OR,3927,108268,112195,148
2020-05-25,OR,3949,109909,113858,148
2020-05-26,OR,3967,111571,115538,148
2020-05-27,OR,4038,112954,116992,148
2020-05-28,OR,4086,115561,119647,151
2020-05-29,OR,4131,118550,122681,151
2020-05-30,OR,4185,122610,126795,153
2020-05-31,OR,4243,124958,129201,153
2020-06-01,OR,4302,127316,131618,154
2020-06-02,OR,4335,129874,134209,157
2020-06-03,OR,4399,132269,136668,159
2020-06-04,OR,4474,134838,139312,159
2020-06-05,OR,4570,138676,143246,161
2020-06-06,OR,4662,141497,146159,163
2020-06-07,OR,4808,143592,148400,164
2020-06-08,OR,4922,144957,149879,164
2020-06-09,OR,4988,148629,153617,169
2020-06-10,OR,5060,151698,156758,169
2020-06-11,OR,5237,156567,161804,171
2020-06-12,OR,5377,160812,166189,173
2020-06-13,OR,5535,164944,170479,174
2020-06-14,OR,5636,168246,173882,176
2020-06-15,OR,5820,170316,176136,180
2020-06-16,OR,6098,173440,179538,182
2020-06-17,OR,6218,178132,184350,183
2020-06-18,OR,6366,182770,189136,187
2020-06-19,OR,6572,187345,193917,188
2020-06-20,OR,6750,187345,194095,189
2020-06-21,OR,6937,195674,202611,190
2020-06-22,OR,7083,199545,206628,192
2020-06-23,OR,7274,203438,210712,192
2020-06-24,OR,7444,206564,214008,195
2020-06-25,OR,7568,209050,216618,197
2020-06-26,OR,7818,209050,216868,202
2020-06-27,OR,8094,219529,227623,202
2020-06-28,OR,8341,219529,227870,202
2020-06-29,OR,8485,226648,235133,204
2020-06-30,OR,8656,228978,237634,207
2020-07-01,OR,8931,234429,243360,208
2020-07-02,OR,9294,241760,251054,209
2020-07-03,OR,9636,245096,254732,209
2020-07-04,OR,9930,245096,255026,213
2020-07-05,OR,10230,253971,264201,215
2020-07-06,OR,10395,257326,267721,215
2020-07-07,OR,10605,261301,271906,220
2020-07-08,OR,10817,265450,276267,224
2020-07-09,OR,11188,270887,282075,230
2020-07-10,OR,11454,275316,286770,232
2020-07-11,OR,11851,280332,292183,232
2020-07-12,OR,12170,284002,296172,234
2020-07-13,OR,12438,288274,300712,237
2020-07-14,OR,12805,292651,305456,244
2020-07-15,OR,13081,298705,311786,247
2020-07-16,OR,13509,305437,318946,249
2020-07-17,OR,13802,310393,324195,254
2020-07-18,OR,14149,316644,330793,257
2020-07-19,OR,14579,321011,335590,260
2020-07-20,OR,14847,325197,340044,262
2020-07-21,OR,15139,330124,345263,269
2020-07-22,OR,15393,337401,352794,269
2020-07-23,OR,15713,342778,358491,273
2020-07-24,OR,16104,350463,366567,282
2020-07-25,OR,16492,357518,374010,286
2020-03-06,PA,2,0,2,0
2020-03-07,PA,4,0,4,0
2020-03-08,PA,6,0,6,0
2020-03-09,PA,10,0,10,0
2020-03-10,PA,12,0,12,0
2020-03-11,PA,16,88,104,0
2020-03-12,PA,22,116,138,0
2020-03-13,PA,41,140,181,0
2020-03-14,PA,47,205,252,0
2020-03-15,PA,63,205,268,0
2020-03-16,PA,76,670,746,0
2020-03-17,PA,96,879,975,0
2020-03-18,PA,133,1187,1320,1
2020-03-19,PA,185,1608,1793,1
2020-03-20,PA,268,2574,2842,1
2020-03-21,PA,371,3766,4137,2
2020-03-22,PA,479,4964,5443,2
2020-03-23,PA,644,6595,7239,6
2020-03-24,PA,851,8643,9494,7
2020-03-25,PA,1127,11193,12320,11
2020-03-26,PA,1687,16441,18128,16
2020-03-27,PA,2218,21016,23234,22
2020-03-28,PA,2751,25254,28005,34
2020-03-29,PA,3394,30061,33455,38
2020-03-30,PA,4087,33777,37864,49
2020-03-31,PA,4843,37645,42488,63
2020-04-01,PA,5805,42427,48232,74
2020-04-02,PA,7016,47698,54714,90
2020-04-03,PA,8420,53695,62115,102
2020-04-04,PA,10017,60013,70030,136
2020-04-05,PA,11510,66261,77771,150
2020-04-06,PA,12980,70874,83854,162
2020-04-07,PA,14559,76719,91278,240
2020-04-08,PA,16239,82299,98538,309
2020-04-09,PA,18228,87374,105602,338
2020-04-10,PA,19979,93040,113019,416
2020-04-11,PA,21655,98498,120153,494
2020-04-12,PA,22833,102057,124890,507
2020-04-13,PA,24199,105593,129792,524
2020-04-14,PA,25345,108286,133631,584
2020-04-15,PA,26490,111094,137584,647
2020-04-16,PA,27735,113735,141470,707
2020-04-17,PA,29441,117932,147373,756
2020-04-18,PA,31069,122896,153965,836
2020-04-19,PA,32284,126570,158854,1112
2020-04-20,PA,33232,129720,162952,1204
2020-04-21,PA,34528,132323,166851,1564
2020-04-22,PA,35684,136272,171956,1622
2020-04-23,PA,37053,142061,179114,1421
2020-04-24,PA,38652,147491,186143,1492
2020-04-25,PA,40049,152886,192935,1537
2020-04-26,PA,41165,157428,198593,1550
2020-04-27,PA,42050,161372,203422,1597
2020-04-28,PA,43264,165824,209088,1716
2020-04-29,PA,44366,170517,214883,2195
2020-04-30,PA,45763,175602,221365,2292
2020-05-01,PA,46971,180477,227448,2354
2020-05-02,PA,48305,187071,235376,2418
2020-05-03,PA,49267,191374,240641,2444
2020-05-04,PA,50092,195498,245590,2458
2020-05-05,PA,50957,199925,250882,3012
2020-05-06,PA,51845,204495,256340,3106
2020-05-07,PA,52915,209873,262788,3416
2020-05-08,PA,54238,216321,270559,3616
2020-05-09,PA,55316,221791,277107,3688
2020-05-10,PA,56611,227772,284383,3707
2020-05-11,PA,57154,231704,288858,3731
2020-05-12,PA,57991,237989,295980,3806
2020-05-13,PA,58698,244171,302869,3943
2020-05-14,PA,59636,251559,311195,4218
2020-05-15,PA,60622,259210,319832,4342
2020-05-16,PA,61611,266225,327836,4403
2020-05-17,PA,62234,270670,332904,4418
2020-05-18,PA,63056,277553,340609,4505
2020-05-19,PA,63666,286034,349700,4624
2020-05-20,PA,63666,286034,349700,4624
2020-05-21,PA,65392,303514,368906,4869
2020-05-22,PA,66258,312743,379001,4984
2020-05-23,PA,66983,321469,388452,5096
2020-05-24,PA,67713,328382,396095,5124
2020-05-25,PA,68186,334928,403114,5139
2020-05-26,PA,68637,339835,408472,5152
2020-05-27,PA,69417,349990,419407,5265
2020-05-28,PA,70042,357804,427846,5373
2020-05-29,PA,71339,366970,438309,5464
2020-05-30,PA,72031,375741,447772,5537
2020-05-31,PA,72546,383111,455657,5555
2020-06-01,PA,72898,389431,462329,5567
2020-06-02,PA,73510,399361,472871,5667
2020-06-03,PA,74022,401369,475391,5741
2020-06-04,PA,74560,416942,491502,5817
2020-06-05,PA,75005,424201,499206,5886
2020-06-06,PA,75706,435122,510828,5931
2020-06-07,PA,76212,444173,520385,5943
2020-06-08,PA,76563,451387,527950,5953
2020-06-09,PA,77056,459248,536304,6014
2020-06-10,PA,77466,466964,544430,6062
2020-06-11,PA,77933,476439,554372,6113
2020-06-12,PA,77999,488385,566384,6162
2020-06-13,PA,78462,496589,575051,6211
2020-06-14,PA,78798,504435,583233,6215
2020-06-15,PA,79121,513909,593030,6243
2020-06-16,PA,79483,523609,603092,6276
2020-06-17,PA,79818,533013,612831,6319
2020-06-18,PA,80236,543832,624068,6361
2020-06-19,PA,80762,556456,637218,6399
2020-06-20,PA,81266,566461,647727,6419
2020-06-21,PA,81730,576015,657745,6423
2020-06-22,PA,82186,585662,667848,6426
2020-06-23,PA,82696,596407,679103,6464
2020-06-24,PA,83191,608217,691408,6518
2020-06-25,PA,83770,621031,704801,6557
2020-06-26,PA,84370,634711,719081,6579
2020-06-27,PA,84370,634711,719081,6579
2020-06-28,PA,85496,657486,742982,6579
2020-06-29,PA,85988,666901,752889,6614
2020-06-30,PA,86606,677581,764187,6649
2020-07-01,PA,87242,689562,776804,6649
2020-07-02,PA,88074,702199,790273,6712
2020-07-03,PA,88741,715403,804144,6746
2020-07-04,PA,89375,725448,814823,6749
2020-07-05,PA,89854,734846,824700,6753
2020-07-06,PA,90304,743020,833324,6754
2020-07-07,PA,91299,758803,850102,6787
2020-07-08,PA,92148,774378,866526,6812
2020-07-09,PA,92867,787156,880023,6848
2020-07-10,PA,93876,804764,898640,6880
2020-07-11,PA,94689,817634,912323,6897
2020-07-12,PA,95266,829018,924284,6904
2020-07-13,PA,95742,835732,931474,6911
2020-07-14,PA,96671,850612,947283,6931
2020-07-15,PA,97665,870984,968649,6957
2020-07-16,PA,98446,885195,983641,6973
2020-07-17,PA,99478,899912,999390,6992
2020-07-18,PA,100241,912486,1012727,7007
2020-07-19,PA,101027,926352,1027379,7015
2020-07-20,PA,101738,938175,1039913,7018
2020-07-21,PA,102765,952998,1055763,7038
2020-07-22,PA,103396,968081,1071477,7063
2020-07-23,PA,104358,981259,1085617,7079
2020-07-24,PA,105571,999377,1104948,7101
2020-07-25,PA,106625,1016705,1123330,7114
2020-03-16,PR,5,9,14,0
2020-03-17,PR,5,13,18,0
2020-03-18,PR,5,31,36,0
2020-03-19,PR,5,56,61,0
2020-03-20,PR,14,114,128,0
2020-03-21,PR,21,143,164,0
2020-03-22,PR,23,183,206,1
2020-03-23,PR,31,189,220,2
2020-03-24,PR,39,268,307,2
2020-03-25,PR,51,317,368,2
2020-03-26,PR,64,377,441,2
2020-03-27,PR,79,519,598,3
2020-03-28,PR,100,739,839,3
2020-03-29,PR,127,841,968,5
2020-03-30,PR,174,931,1105,6
2020-03-31,PR,239,1195,1434,8
2020-04-01,PR,286,1409,1695,11
2020-04-02,PR,316,1604,1920,12
2020-04-03,PR,378,2049,2427,15
2020-04-04,PR,452,2605,3057,18
2020-04-05,PR,475,3073,3548,20
2020-04-06,PR,513,3432,3945,21
2020-04-07,PR,573,3966,4539,23
2020-04-08,PR,620,4266,4886,24
2020-04-09,PR,683,4703,5386,33
2020-04-10,PR,725,5121,5846,39
2020-04-11,PR,788,5583,6371,42
2020-04-12,PR,897,5819,6716,44
2020-04-13,PR,903,5960,6863,45
2020-04-14,PR,923,6284,7207,45
2020-04-15,PR,974,6825,7799,51
2020-04-16,PR,1043,7315,8358,56
2020-04-17,PR,1068,7864,8932,58
2020-04-18,PR,1118,8055,9173,60
2020-04-19,PR,1213,8280,9493,62
2020-04-20,PR,1252,8486,9738,63
2020-04-21,PR,1298,8789,10087,64
2020-04-22,PR,915,8842,9757,67
2020-04-23,PR,915,9313,10228,69
2020-04-24,PR,1276,9313,10589,77
2020-04-25,PR,1307,9313,10620,83
2020-04-26,PR,1371,9313,10684,84
2020-04-27,PR,1389,9313,10702,84
2020-04-28,PR,1400,9313,10713,86
2020-04-29,PR,1433,9313,10746,86
2020-04-30,PR,1539,9313,10852,92
2020-05-01,PR,1575,9313,10888,92
2020-05-02,PR,1757,9313,11070,95
2020-05-03,PR,1808,9313,11121,97
2020-05-04,PR,1843,9313,11156,97
2020-05-05,PR,1924,9313,11237,99
2020-05-06,PR,1968,0,1968,99
2020-05-07,PR,2031,0,2031,102
2020-05-08,PR,2156,0,2156,107
2020-05-09,PR,2173,0,2173,108
2020-05-10,PR,2198,0,2198,111
2020-05-11,PR,2256,0,2256,113
2020-05-12,PR,2299,0,2299,114
2020-05-13,PR,2329,0,2329,115
2020-05-14,PR,2427,0,2427,117
2020-05-15,PR,2542,0,2542,122
2020-05-16,PR,2589,0,2589,122
2020-05-17,PR,2646,0,2646,123
2020-05-18,PR,2710,0,2710,124
2020-05-19,PR,2805,0,2805,124
2020-05-20,PR,2866,0,2866,125
2020-05-21,PR,2913,40488,43401,126
2020-05-22,PR,3030,40488,43518,126
2020-05-23,PR,3100,40488,43588,127
2020-05-24,PR,3189,40488,43677,127
2020-05-25,PR,3260,40488,43748,129
2020-05-26,PR,3324,40488,43812,129
2020-05-27,PR,3397,40488,43885,129
2020-05-28,PR,3486,60422,63908,131
2020-05-29,PR,3647,60422,64069,132
2020-05-30,PR,3718,60422,64140,133
2020-05-31,PR,3776,60422,64198,136
2020-06-01,PR,3873,60422,64295,136
2020-06-02,PR,3935,60422,64357,138
2020-06-03,PR,4023,60422,64445,140
2020-06-04,PR,4508,60422,64930,140
2020-06-05,PR,4620,60422,65042,141
2020-06-06,PR,4915,88685,93600,142
2020-06-07,PR,4985,88685,93670,142
2020-06-08,PR,5046,88685,93731,142
2020-06-09,PR,5185,88685,93870,142
2020-06-10,PR,5329,88685,94014,143
2020-06-11,PR,5352,88685,94037,144
2020-06-12,PR,5536,113280,118816,146
2020-06-13,PR,5690,113280,118970,146
2020-06-14,PR,5811,113280,119091,147
2020-06-15,PR,5890,113280,119170,147
2020-06-16,PR,5951,113280,119231,147
2020-06-17,PR,6003,113280,119283,147
2020-06-18,PR,6111,113280,119391,147
2020-06-19,PR,6195,113280,119475,147
2020-06-20,PR,6463,113280,119743,147
2020-06-21,PR,6525,113280,119805,149
2020-06-22,PR,6564,113280,119844,149
2020-06-23,PR,6685,113280,119965,149
2020-06-24,PR,6820,113280,120100,149
2020-06-25,PR,6877,113280,120157,151
2020-06-26,PR,6922,113280,120202,151
2020-06-27,PR,7066,113280,120346,152
2020-06-28,PR,7189,113280,120469,153
2020-06-29,PR,7250,192686,199936,153
2020-06-30,PR,7465,192686,200151,153
2020-07-01,PR,7537,192686,200223,153
2020-07-02,PR,7608,192686,200294,153
2020-07-03,PR,7683,192686,200369,154
2020-07-04,PR,7787,192686,200473,155
2020-07-05,PR,7916,192686,200602,155
2020-07-06,PR,8585,192686,201271,155
2020-07-07,PR,8714,192686,201400,157
2020-07-08,PR,8745,192686,201431,159
2020-07-09,PR,8862,255766,264628,159
2020-07-10,PR,9137,255766,264903,159
2020-07-11,PR,9366,255766,265132,167
2020-07-12,PR,9654,255766,265420,167
2020-07-13,PR,10010,255766,265776,167
2020-07-14,PR,10123,255766,265889,169
2020-07-15,PR,10379,255766,266145,171
2020-07-16,PR,10574,255766,266340,172
2020-07-17,PR,11120,255766,266886,177
2020-07-18,PR,11453,255766,267219,178
2020-07-19,PR,12063,255766,267829,178
2020-07-20,PR,12461,255766,268227,180
2020-07-21,PR,12940,255766,268706,180
2020-07-22,PR,13038,255766,268804,185
2020-07-23,PR,13473,305972,319445,188
2020-07-24,PR,13967,305972,319939,191
2020-07-25,PR,14540,305972,320512,201
2020-03-01,RI,2,2,4,0
2020-03-02,RI,2,3,5,0
2020-03-03,RI,2,5,7,0
2020-03-04,RI,2,15,17,0
2020-03-05,RI,3,19,22,0
2020-03-06,RI,3,30,33,0
2020-03-07,RI,3,49,52,0
2020-03-08,RI,3,67,70,0
2020-03-09,RI,4,82,86,0
2020-03-10,RI,5,105,110,0
2020-03-11,RI,5,139,144,0
2020-03-12,RI,13,176,189,0
2020-03-13,RI,19,224,243,0
2020-03-14,RI,19,310,329,0
2020-03-15,RI,20,364,384,0
2020-03-16,RI,22,455,477,0
2020-03-17,RI,33,608,641,0
2020-03-18,RI,44,719,763,0
2020-03-19,RI,61,968,1029,0
2020-03-20,RI,74,1161,1235,0
2020-03-21,RI,88,1284,1372,0
2020-03-22,RI,113,1547,1660,0
2020-03-23,RI,129,1713,1842,0
2020-03-24,RI,148,1951,2099,0
2020-03-25,RI,176,2124,2300,0
2020-03-26,RI,217,2300,2517,0
2020-03-27,RI,248,2502,2750,0
2020-03-28,RI,312,2742,3054,0
2020-03-29,RI,417,3056,3473,3
2020-03-30,RI,495,3246,3741,4
2020-03-31,RI,568,3544,4112,8
2020-04-01,RI,668,4189,4857,10
2020-04-02,RI,730,4625,5355,12
2020-04-03,RI,831,5342,6173,14
2020-04-04,RI,968,5962,6930,17
2020-04-05,RI,1150,7032,8182,25
2020-04-06,RI,1356,8609,9965,27
2020-04-07,RI,1617,10095,11712,30
2020-04-08,RI,1890,11667,13557,35
2020-04-09,RI,2169,13029,15198,43
2020-04-10,RI,2573,15403,17976,49
2020-04-11,RI,2853,17130,19983,56
2020-04-12,RI,3142,18578,21720,63
2020-04-13,RI,3329,19431,22760,73
2020-04-14,RI,3596,20990,24586,80
2020-04-15,RI,3903,22567,26470,87
2020-04-16,RI,4295,24657,28952,105
2020-04-17,RI,4585,26157,30742,118
2020-04-18,RI,4868,27527,32395,150
2020-04-19,RI,5207,29289,34496,164
2020-04-20,RI,5585,30883,36468,175
2020-04-21,RI,5972,32606,38578,186
2020-04-22,RI,6354,34528,40882,201
2020-04-23,RI,6773,36423,43196,213
2020-04-24,RI,7188,39071,46259,202
2020-04-25,RI,7493,40860,48353,215
2020-04-26,RI,7769,42746,50515,226
2020-04-27,RI,7972,43915,51887,233
2020-04-28,RI,8296,45689,53985,239
2020-04-29,RI,8668,48143,56811,251
2020-04-30,RI,9016,50100,59116,266
2020-05-01,RI,9333,52328,61661,279
2020-05-02,RI,9522,53623,63145,296
2020-05-03,RI,9703,55233,64936,320
2020-05-04,RI,9994,56802,66796,341
2020-05-05,RI,10297,58781,69078,355
2020-05-06,RI,10639,60718,71357,370
2020-05-07,RI,10910,62647,73557,388
2020-05-08,RI,11141,64338,75479,399
2020-05-09,RI,11427,66604,78031,418
2020-05-10,RI,11613,68106,79719,422
2020-05-11,RI,11788,69365,81153,430
2020-05-12,RI,12007,70916,82923,444
2020-05-13,RI,12203,72840,85043,462
2020-05-14,RI,12431,74767,87198,468
2020-05-15,RI,12663,76467,89130,479
2020-05-16,RI,12915,78231,91146,489
2020-05-17,RI,13040,79768,92808,499
2020-05-18,RI,13177,81057,94234,506
2020-05-19,RI,13392,82935,96327,532
2020-05-20,RI,13579,84460,98039,538
2020-05-21,RI,13748,86399,100147,556
2020-05-22,RI,13949,87850,101799,579
2020-05-23,RI,14057,89167,103224,597
2020-05-24,RI,14141,89924,104065,608
2020-05-25,RI,14211,90674,104885,608
2020-05-26,RI,14365,92400,106765,634
2020-05-27,RI,14498,93504,108002,655
2020-05-28,RI,14630,94575,109205,677
2020-05-29,RI,14808,96112,110920,693
2020-05-30,RI,14912,97940,112852,711
2020-05-31,RI,14988,98790,113778,718
2020-06-01,RI,15087,100112,115199,720
2020-06-02,RI,15194,101512,116706,732
2020-06-03,RI,15299,103136,118435,742
2020-06-04,RI,15416,105136,120552,756
2020-06-05,RI,15521,106656,122177,772
2020-06-06,RI,15589,107782,123371,772
2020-06-07,RI,15638,108540,124178,772
2020-06-08,RI,15683,109424,125107,799
2020-06-09,RI,15751,110588,126339,808
2020-06-10,RI,15855,111952,127807,812
2020-06-11,RI,15942,113390,129332,823
2020-06-12,RI,16023,115483,131506,833
2020-06-13,RI,16072,116709,132781,833
2020-06-14,RI,16104,117593,133697,833
2020-06-15,RI,16180,119304,135484,851
2020-06-16,RI,16232,120790,137022,865
2020-06-17,RI,16283,121997,138280,876
2020-06-18,RI,16354,123216,139570,885
2020-06-19,RI,16413,124397,140810,894
2020-06-20,RI,16449,125078,141527,894
2020-06-21,RI,16476,125701,142177,894
2020-06-22,RI,16535,127297,143832,903
2020-06-23,RI,16612,128896,145508,906
2020-06-24,RI,16663,130382,147045,912
2020-06-25,RI,16708,131788,148496,920
2020-06-26,RI,16777,133102,149879,927
2020-06-27,RI,16813,134300,151113,927
2020-06-28,RI,16835,134878,151713,927
2020-06-29,RI,16871,136198,153069,946
2020-06-30,RI,16911,137172,154083,950
2020-07-01,RI,16976,139063,156039,956
2020-07-02,RI,17035,140048,157083,959
2020-07-03,RI,17057,140721,157778,960
2020-07-04,RI,17084,141673,158757,960
2020-07-05,RI,17108,143047,160155,960
2020-07-06,RI,17163,144551,161714,960
2020-07-07,RI,17204,146066,163270,969
2020-07-08,RI,17204,146066,163270,971
2020-07-09,RI,17243,147894,165137,974
2020-07-10,RI,17312,149343,166655,976
2020-07-11,RI,17312,149343,166655,976
2020-07-12,RI,17312,149343,166655,976
2020-07-13,RI,17487,155756,173243,984
2020-07-14,RI,17588,157070,174658,985
2020-07-15,RI,17640,158235,175875,987
2020-07-16,RI,17711,159677,177388,988
2020-07-17,RI,17793,161408,179201,990
2020-07-18,RI,17793,161408,179201,990
2020-07-19,RI,17793,161408,179201,990
2020-07-20,RI,17904,165721,183625,995
2020-07-21,RI,17986,166978,184964,996
2020-07-22,RI,18062,168794,186856,997
2020-07-23,RI,18148,171191,189339,1001
2020-07-24,RI,18224,171804,190028,1002
2020-07-25,RI,18224,171804,190028,1002
2020-03-04,SC,0,5,5,0
2020-03-05,SC,0,5,5,0
2020-03-06,SC,0,5,5,0
2020-03-07,SC,2,8,10,0
2020-03-08,SC,2,8,10,0
2020-03-09,SC,7,24,31,0
2020-03-10,SC,7,24,31,0
2020-03-11,SC,9,32,41,0
2020-03-12,SC,10,48,58,0
2020-03-13,SC,12,75,87,0
2020-03-14,SC,13,110,123,0
2020-03-15,SC,19,154,173,0
2020-03-16,SC,28,235,263,1
2020-03-17,SC,33,311,344,1
2020-03-18,SC,60,583,643,1
2020-03-19,SC,60,583,643,1
2020-03-20,SC,81,833,914,1
2020-03-21,SC,152,1255,1407,1
2020-03-22,SC,195,1466,1661,3
2020-03-23,SC,298,1466,1764,5
2020-03-24,SC,298,2012,2310,5
2020-03-25,SC,424,2303,2727,7
2020-03-26,SC,456,2307,2763,9
2020-03-27,SC,456,2307,2763,9
2020-03-28,SC,539,2408,2947,13
2020-03-29,SC,774,3015,3789,16
2020-03-30,SC,925,4160,5085,18
2020-03-31,SC,1083,4616,5699,22
2020-04-01,SC,1293,5033,6326,26
2020-04-02,SC,1554,5441,6995,31
2020-04-03,SC,1554,5441,6995,31
2020-04-04,SC,1917,16397,18314,40
2020-04-05,SC,2049,16927,18976,44
2020-04-06,SC,2049,16927,18976,44
2020-04-07,SC,2417,21263,23680,51
2020-04-08,SC,2552,22082,24634,63
2020-04-09,SC,2792,24575,27367,67
2020-04-10,SC,3065,25118,28183,72
2020-04-11,SC,3207,26886,30093,80
2020-04-12,SC,3319,28106,31425,82
2020-04-13,SC,3319,28106,31425,82
2020-04-14,SC,3553,30319,33872,97
2020-04-15,SC,3656,31077,34733,107
2020-04-16,SC,3656,31077,34733,107
2020-04-17,SC,3931,32353,36284,109
2020-04-18,SC,4246,34587,38833,119
2020-04-19,SC,4377,36103,40480,120
2020-04-20,SC,4377,36103,40480,120
2020-04-21,SC,4439,36838,41277,124
2020-04-22,SC,4761,38350,43111,140
2020-04-23,SC,4917,39546,44463,150
2020-04-24,SC,4917,39546,44463,150
2020-04-25,SC,5253,43761,49014,166
2020-04-26,SC,5490,45271,50761,174
2020-04-27,SC,5490,45271,50761,174
2020-04-28,SC,5613,46532,52145,177
2020-04-29,SC,5881,48336,54217,203
2020-04-30,SC,6095,50417,56512,244
2020-05-01,SC,6258,53121,59379,256
2020-05-02,SC,6489,55127,61616,267
2020-05-03,SC,6626,57562,64188,275
2020-05-04,SC,6626,57562,64188,275
2020-05-05,SC,6757,61014,67771,283
2020-05-06,SC,6936,70546,77482,305
2020-05-07,SC,6936,70546,77482,305
2020-05-08,SC,7142,66300,73442,316
2020-05-09,SC,7531,73432,80963,330
2020-05-10,SC,7653,76804,84457,331
2020-05-11,SC,7653,76804,84457,331
2020-05-12,SC,7927,85213,93140,355
2020-05-13,SC,7927,85213,93140,355
2020-05-14,SC,8189,94346,102535,371
2020-05-15,SC,8407,101209,109616,380
2020-05-16,SC,8407,101209,109616,380
2020-05-17,SC,8816,111670,120486,380
2020-05-18,SC,8942,122617,131559,391
2020-05-19,SC,9056,126007,135063,399
2020-05-20,SC,9056,126007,135063,399
2020-05-21,SC,9175,129063,138238,407
2020-05-22,SC,9638,140385,150023,419
2020-05-23,SC,9895,149015,158910,425
2020-05-24,SC,10096,153851,163947,435
2020-05-25,SC,10178,155842,166020,440
2020-05-26,SC,10416,162318,172734,446
2020-05-27,SC,10623,165060,175683,466
2020-05-28,SC,10788,171461,182249,470
2020-05-29,SC,11131,177126,188257,483
2020-05-30,SC,11394,178125,189519,487
2020-05-31,SC,11861,188355,200216,494
2020-06-01,SC,12148,192540,204688,500
2020-06-02,SC,12415,206362,218777,501
2020-06-03,SC,12651,210274,222925,518
2020-06-04,SC,13005,217846,230851,525
2020-06-05,SC,13453,217846,231299,538
2020-06-06,SC,13916,218828,232744,545
2020-06-07,SC,14286,223573,237859,546
2020-06-08,SC,14800,229861,244661,557
2020-06-09,SC,15228,232754,247982,568
2020-06-10,SC,15759,236773,252532,575
2020-06-11,SC,16441,213616,230057,588
2020-06-12,SC,17170,218889,236059,593
2020-06-13,SC,17955,223951,241906,599
2020-06-14,SC,18795,229541,248336,600
2020-06-15,SC,19378,236179,255557,602
2020-06-16,SC,19990,247689,267679,607
2020-06-17,SC,20556,252198,272754,617
2020-06-18,SC,21548,258975,280523,621
2020-06-19,SC,22631,265669,288300,639
2020-06-20,SC,23786,272463,296249,644
2020-06-21,SC,24693,277974,302667,653
2020-06-22,SC,25701,278179,303880,659
2020-06-23,SC,26613,282638,309251,673
2020-06-24,SC,27897,290311,318208,683
2020-06-25,SC,29022,304336,333358,693
2020-06-26,SC,30335,304336,334671,694
2020-06-27,SC,31939,319225,351164,711
2020-06-28,SC,33320,326482,359802,716
2020-06-29,SC,34644,334661,369305,720
2020-06-30,SC,36399,344173,380572,739
2020-07-01,SC,37919,351953,389872,766
2020-07-02,SC,39701,361700,401401,784
2020-07-03,SC,41532,367500,409032,793
2020-07-04,SC,43386,377307,420693,813
2020-07-05,SC,44847,385962,430809,820
2020-07-06,SC,46380,393477,439857,827
2020-07-07,SC,47352,397939,445291,846
2020-07-08,SC,48909,404931,453840,884
2020-07-09,SC,50691,413074,463765,905
2020-07-10,SC,52419,422816,475235,929
2020-07-11,SC,54699,433391,488090,951
2020-07-12,SC,56648,435860,492508,961
2020-07-13,SC,58168,448933,507101,972
2020-07-14,SC,60389,457092,517481,993
2020-07-15,SC,62245,463738,525983,998
2020-07-16,SC,64083,475881,539964,1070
2020-07-17,SC,66060,487315,553375,1096
2020-07-18,SC,67612,494381,561993,1135
2020-07-19,SC,69986,507400,577386,1155
2020-07-20,SC,71445,516871,588316,1164
2020-07-21,SC,73337,525356,598693,1221
2020-07-22,SC,75042,534118,609160,1285
2020-07-23,SC,76606,541868,618474,1334
2020-07-24,SC,78607,550765,629372,1385
2020-07-25,SC,80008,558482,638490,1465
2020-03-07,SD,0,5,5,0
2020-03-08,SD,0,5,5,0
2020-03-09,SD,0,5,5,0
2020-03-10,SD,0,11,11,0
2020-03-11,SD,5,13,18,0
2020-03-12,SD,8,27,35,0
2020-03-13,SD,9,73,82,0
2020-03-14,SD,9,182,191,0
2020-03-15,SD,9,327,336,0
2020-03-16,SD,10,494,504,0
2020-03-17,SD,11,551,562,0
2020-03-18,SD,11,551,562,1
2020-03-19,SD,11,551,562,1
2020-03-20,SD,14,663,677,1
2020-03-21,SD,14,691,705,1
2020-03-22,SD,21,740,761,1
2020-03-23,SD,28,762,790,1
2020-03-24,SD,30,790,820,1
2020-03-25,SD,41,819,860,1
2020-03-26,SD,46,1973,2019,1
2020-03-27,SD,58,2387,2445,1
2020-03-28,SD,68,2592,2660,1
2020-03-29,SD,90,3127,3217,1
2020-03-30,SD,101,3478,3579,1
2020-03-31,SD,108,3609,3717,1
2020-04-01,SD,129,3903,4032,2
2020-04-02,SD,165,4217,4382,2
2020-04-03,SD,187,4593,4780,2
2020-04-04,SD,212,5012,5224,2
2020-04-05,SD,240,5353,5593,2
2020-04-06,SD,288,5732,6020,4
2020-04-07,SD,320,5948,6268,6
2020-04-08,SD,393,6355,6748,6
2020-04-09,SD,447,6700,7147,6
2020-04-10,SD,536,7111,7647,6
2020-04-11,SD,626,7378,8004,6
2020-04-12,SD,730,7823,8553,6
2020-04-13,SD,868,8134,9002,6
2020-04-14,SD,988,8308,9296,6
2020-04-15,SD,1168,8691,9859,6
2020-04-16,SD,1311,9239,10550,7
2020-04-17,SD,1411,9651,11062,7
2020-04-18,SD,1542,10118,11660,7
2020-04-19,SD,1635,10427,12062,7
2020-04-20,SD,1685,10641,12326,7
2020-04-21,SD,1755,11060,12815,8
2020-04-22,SD,1858,11588,13446,8
2020-04-23,SD,1956,12109,14065,9
2020-04-24,SD,2040,12784,14824,10
2020-04-25,SD,2147,13449,15596,10
2020-04-26,SD,2212,14062,16274,11
2020-04-27,SD,2245,14130,16375,11
2020-04-28,SD,2313,14299,16612,11
2020-04-29,SD,2373,14460,16833,13
2020-04-30,SD,2449,14579,17028,17
2020-05-01,SD,2525,14838,17363,21
2020-05-02,SD,2588,15503,18091,21
2020-05-03,SD,2631,15786,18417,21
2020-05-04,SD,2668,16045,18713,21
2020-05-05,SD,2721,16301,19022,24
2020-05-06,SD,2779,16637,19416,29
2020-05-07,SD,2905,17209,20114,31
2020-05-08,SD,3144,18149,21293,31
2020-05-09,SD,3393,19559,22952,34
2020-05-10,SD,3517,20377,23894,34
2020-05-11,SD,3614,20964,24578,34
2020-05-12,SD,3663,21534,25197,39
2020-05-13,SD,3732,22112,25844,39
2020-05-14,SD,3792,22681,26473,43
2020-05-15,SD,3887,23527,27414,44
2020-05-16,SD,3959,24217,28176,44
2020-05-17,SD,3987,24572,28559,44
2020-05-18,SD,4027,25018,29045,44
2020-05-19,SD,4085,25624,29709,46
2020-05-20,SD,4177,26212,30389,46
2020-05-21,SD,4250,27051,31301,48
2020-05-22,SD,4356,27988,32344,50
2020-05-23,SD,4468,29060,33528,50
2020-05-24,SD,4563,30342,34905,50
2020-05-25,SD,4586,30697,35283,50
2020-05-26,SD,4653,32385,37038,50
2020-05-27,SD,4710,33296,38006,54
2020-05-28,SD,4793,34233,39026,54
2020-05-29,SD,4866,35816,40682,59
2020-05-30,SD,4960,37978,42938,62
2020-05-31,SD,4993,39135,44128,62
2020-06-01,SD,5034,40627,45661,62
2020-06-02,SD,5067,41779,46846,62
2020-06-03,SD,5162,43500,48662,62
2020-06-04,SD,5247,47375,52622,64
2020-06-05,SD,5277,48086,53363,65
2020-06-06,SD,5367,50091,55458,65
2020-06-07,SD,5438,51622,57060,65
2020-06-08,SD,5471,52348,57819,65
2020-06-09,SD,5523,53636,59159,68
2020-06-10,SD,5604,55081,60685,69
2020-06-11,SD,5665,56079,61744,73
2020-06-12,SD,5742,57263,63005,74
2020-06-13,SD,5833,58680,64513,75
2020-06-14,SD,5898,59421,65319,75
2020-06-15,SD,5928,60467,66395,75
2020-06-16,SD,5966,61236,67202,77
2020-06-17,SD,6050,62938,68988,78
2020-06-18,SD,6109,64244,70353,78
2020-06-19,SD,6158,65035,71193,81
2020-06-20,SD,6225,65690,71915,81
2020-06-21,SD,6297,66729,73026,81
2020-06-22,SD,6326,67003,73329,81
2020-06-23,SD,6353,67633,73986,83
2020-06-24,SD,6419,68658,75077,84
2020-06-25,SD,6479,69375,75854,87
2020-06-26,SD,6535,70480,77015,88
2020-06-27,SD,6626,71474,78100,91
2020-06-28,SD,6681,72212,78893,91
2020-06-29,SD,6716,72741,79457,91
2020-06-30,SD,6764,73324,80088,91
2020-07-01,SD,6826,74117,80943,93
2020-07-02,SD,6893,75048,81941,97
2020-07-03,SD,6978,76015,82993,97
2020-07-04,SD,7028,76802,83830,97
2020-07-05,SD,7063,76940,84003,97
2020-07-06,SD,7105,77198,84303,97
2020-07-07,SD,7163,78202,85365,98
2020-07-08,SD,7242,78984,86226,98
2020-07-09,SD,7336,79974,87310,101
2020-07-10,SD,7401,81141,88542,107
2020-07-11,SD,7454,82152,89606,109
2020-07-12,SD,7499,83109,90608,109
2020-07-13,SD,7524,83854,91378,109
2020-07-14,SD,7572,84592,92164,109
2020-07-15,SD,7652,85891,93543,111
2020-07-16,SD,7694,86342,94036,115
2020-07-17,SD,7789,88184,95973,116
2020-07-18,SD,7862,89385,97247,116
2020-07-19,SD,7906,90181,98087,118
2020-07-20,SD,7943,90711,98654,118
2020-07-21,SD,8019,91826,99845,118
2020-07-22,SD,8077,92981,101058,119
2020-07-23,SD,8143,94393,102536,121
2020-07-24,SD,8200,95290,103490,122
2020-07-25,SD,8305,97608,105913,122
2020-03-05,TN,1,0,1,0
2020-03-06,TN,1,0,1,0
2020-03-07,TN,1,0,1,0
2020-03-08,TN,3,0,3,0
2020-03-09,TN,3,0,3,0
2020-03-10,TN,7,0,7,0
2020-03-11,TN,7,50,57,0
2020-03-12,TN,18,79,97,0
2020-03-13,TN,26,116,142,0
2020-03-14,TN,32,130,162,0
2020-03-15,TN,39,157,196,0
2020-03-16,TN,52,270,322,0
2020-03-17,TN,73,330,403,0
2020-03-18,TN,98,349,447,0
2020-03-19,TN,154,349,503,0
2020-03-20,TN,228,563,791,0
2020-03-21,TN,371,3272,3643,0
2020-03-22,TN,505,3272,3777,0
2020-03-23,TN,615,3272,3887,2
2020-03-24,TN,667,10517,11184,2
2020-03-25,TN,784,11012,11796,3
2020-03-26,TN,957,13952,14909,3
2020-03-27,TN,1203,14888,16091,6
2020-03-28,TN,1373,16965,18338,6
2020-03-29,TN,1537,19037,20574,7
2020-03-30,TN,1834,21470,23304,13
2020-03-31,TN,2239,25121,27360,23
2020-04-01,TN,2683,29769,32452,24
2020-04-02,TN,2845,31766,34611,32
2020-04-03,TN,3067,34772,37839,37
2020-04-04,TN,3321,38070,41391,43
2020-04-05,TN,3633,41667,45300,44
2020-04-06,TN,3802,43548,47350,65
2020-04-07,TN,4138,48736,52874,72
2020-04-08,TN,4362,52256,56618,79
2020-04-09,TN,4634,55215,59849,94
2020-04-10,TN,4862,57937,62799,98
2020-04-11,TN,5114,61714,66828,101
2020-04-12,TN,5308,65369,70677,101
2020-04-13,TN,5610,70585,76195,109
2020-04-14,TN,5823,73008,78831,124
2020-04-15,TN,6079,74817,80896,135
2020-04-16,TN,6262,78787,85049,141
2020-04-17,TN,6589,80684,87273,142
2020-04-18,TN,6762,83824,90586,145
2020-04-19,TN,7070,90028,97098,148
2020-04-20,TN,7238,93451,100689,152
2020-04-21,TN,7394,100788,108182,157
2020-04-22,TN,7842,107138,114980,166
2020-04-23,TN,8266,114834,123100,170
2020-04-24,TN,8726,122602,131328,168
2020-04-25,TN,9189,132217,141406,178
2020-04-26,TN,9667,137807,147474,181
2020-04-27,TN,9918,144484,154402,184
2020-04-28,TN,10052,151876,161928,188
2020-04-29,TN,10366,158183,168549,195
2020-04-30,TN,10735,166891,177626,199
2020-05-01,TN,11891,174241,186132,204
2020-05-02,TN,12661,183615,196276,209
2020-05-03,TN,13177,191430,204607,210
2020-05-04,TN,13571,197872,211443,219
2020-05-05,TN,13690,205172,218862,226
2020-05-06,TN,13938,213163,227101,239
2020-05-07,TN,14096,222232,236328,237
2020-05-08,TN,14441,229137,243578,241
2020-05-09,TN,14768,237980,252748,242
2020-05-10,TN,14985,246884,261869,243
2020-05-11,TN,15544,257733,273277,251
2020-05-12,TN,16111,267713,283824,265
2020-05-13,TN,16370,276547,292917,273
2020-05-14,TN,16699,285618,302317,287
2020-05-15,TN,16970,292786,309756,290
2020-05-16,TN,17288,302913,320201,295
2020-05-17,TN,17388,307892,325280,298
2020-05-18,TN,18011,319417,337428,301
2020-05-19,TN,18378,327745,346123,305
2020-05-20,TN,18532,335481,354013,309
2020-05-21,TN,18961,341622,360583,313
2020-05-22,TN,19394,348776,368170,315
2020-05-23,TN,19789,353969,373758,329
2020-05-24,TN,20145,363431,383576,336
2020-05-25,TN,20607,375612,396219,338
2020-05-26,TN,20965,382539,403504,343
2020-05-27,TN,21306,388324,409630,353
2020-05-28,TN,21679,394310,415989,356
2020-05-29,TN,22085,399882,421967,360
2020-05-30,TN,22566,404480,427046,364
2020-05-31,TN,23006,412971,435977,364
2020-06-01,TN,23554,424939,448493,367
2020-06-02,TN,24375,437761,462136,381
2020-06-03,TN,24822,445957,470779,388
2020-06-04,TN,25120,451018,476138,401
2020-06-05,TN,25520,456652,482172,408
2020-06-06,TN,26071,465350,491421,417
2020-06-07,TN,26381,472387,498768,418
2020-06-08,TN,26944,485819,512763,421
2020-06-09,TN,27575,493622,521197,435
2020-06-10,TN,28061,500766,528827,436
2020-06-11,TN,28538,506756,535294,441
2020-06-12,TN,29126,561047,590173,468
2020-06-13,TN,29541,571821,601362,472
2020-06-14,TN,30432,584788,615220,475
2020-06-15,TN,31160,598818,629978,483
2020-06-16,TN,31830,607160,638990,493
2020-06-17,TN,32143,612430,644573,497
2020-06-18,TN,32829,619565,652394,509
2020-06-19,TN,34017,627672,661689,515
2020-06-20,TN,34446,640894,675340,524
2020-06-21,TN,35102,650527,685629,526
2020-06-22,TN,35553,664552,700105,531
2020-06-23,TN,36303,669116,705419,542
2020-06-24,TN,37235,681069,718304,556
2020-06-25,TN,38034,689515,727549,567
2020-06-26,TN,39444,702588,742032,577
2020-06-27,TN,40172,708381,748553,584
2020-06-28,TN,40172,708381,748553,584
2020-06-29,TN,42297,734909,777206,592
2020-06-30,TN,43509,749618,793127,604
2020-07-01,TN,45315,772571,817886,609
2020-07-02,TN,46890,791564,838454,620
2020-07-03,TN,48712,813777,862489,633
2020-07-04,TN,50140,828464,878604,637
2020-07-05,TN,51431,844735,896166,646
2020-07-06,TN,52155,852463,904618,653
2020-07-07,TN,53514,867685,921199,665
2020-07-08,TN,55986,894973,950959,685
2020-07-09,TN,57591,915123,972714,710
2020-07-10,TN,59546,935029,994575,723
2020-07-11,TN,61006,946108,1007114,738
2020-07-12,TN,61960,956055,1018015,741
2020-07-13,TN,65274,988687,1053961,749
2020-07-14,TN,66788,1005100,1071888,767
2020-07-15,TN,69061,1028612,1097673,783
2020-07-16,TN,71540,1052157,1123697,796
2020-07-17,TN,73819,1076853,1150672,815
2020-07-18,TN,76336,1097316,1173652,838
2020-07-19,TN,78115,1119182,1197297,843
2020-07-20,TN,79754,1135413,1215167,847
2020-07-21,TN,81944,1156289,1238233,871
2020-07-22,TN,84417,1179411,1263828,888
2020-07-23,TN,86987,1208998,1295985,925
2020-07-24,TN,89078,1233535,1322613,938
2020-07-25,TN,90796,1241578,1332374,964
2020-03-04,TX,1,0,1,0
2020-03-05,TX,1,0,1,0
2020-03-06,TX,5,0,5,0
2020-03-07,TX,8,0,8,0
2020-03-08,TX,8,0,8,0
2020-03-09,TX,12,0,12,0
2020-03-10,TX,13,0,13,0
2020-03-11,TX,21,0,21,0
2020-03-12,TX,23,0,23,0
2020-03-13,TX,39,0,39,0
2020-03-14,TX,51,0,51,0
2020-03-15,TX,56,0,56,0
2020-03-16,TX,57,0,57,0
2020-03-17,TX,64,1204,1268,1
2020-03-18,TX,83,1824,1907,2
2020-03-19,TX,143,2212,2355,3
2020-03-20,TX,194,5083,5277,5
2020-03-21,TX,304,6218,6522,5
2020-03-22,TX,334,8422,8756,5
2020-03-23,TX,352,9703,10055,8
2020-03-24,TX,410,10757,11167,9
2020-03-25,TX,974,12520,13494,12
2020-03-26,TX,1396,20028,21424,18
2020-03-27,TX,1731,21935,23666,23
2020-03-28,TX,2052,23208,25260,27
2020-03-29,TX,2552,23208,25760,34
2020-03-30,TX,2877,33003,35880,34
2020-03-31,TX,3266,39726,42992,41
2020-04-01,TX,3997,43860,47857,58
2020-04-02,TX,4669,46010,50679,70
2020-04-03,TX,5330,50434,55764,90
2020-04-04,TX,6110,57641,63751,105
2020-04-05,TX,6812,64126,70938,127
2020-04-06,TX,7276,78081,85357,140
2020-04-07,TX,8262,80387,88649,154
2020-04-08,TX,9353,86905,96258,177
2020-04-09,TX,10230,95904,106134,199
2020-04-10,TX,11671,104047,115718,226
2020-04-11,TX,12561,107972,120533,254
2020-04-12,TX,13484,111049,124533,271
2020-04-13,TX,13906,119320,133226,287
2020-04-14,TX,14624,131843,146467,318
2020-04-15,TX,15492,136318,151810,364
2020-04-16,TX,16455,142092,158547,393
2020-04-17,TX,17371,152165,169536,428
2020-04-18,TX,18260,157979,176239,453
2020-04-19,TX,18923,163787,182710,477
2020-04-20,TX,19458,170936,190394,495
2020-04-21,TX,20196,185203,205399,517
2020-04-22,TX,21069,195714,216783,543
2020-04-23,TX,21944,203134,225078,561
2020-04-24,TX,22806,219741,242547,593
2020-04-25,TX,23773,239043,262816,623
2020-04-26,TX,24631,251390,276021,648
2020-04-27,TX,25297,265220,290517,663
2020-04-28,TX,26171,274213,300384,690
2020-04-29,TX,27054,287736,314790,732
2020-04-30,TX,28087,302213,330300,782
2020-05-01,TX,29229,322546,351775,816
2020-05-02,TX,30522,350126,380648,847
2020-05-03,TX,31548,359012,390560,867
2020-05-04,TX,32332,375066,407398,884
2020-05-05,TX,33369,393841,427210,906
2020-05-06,TX,34422,404516,438938,948
2020-05-07,TX,35390,419772,455162,973
2020-05-08,TX,36609,440509,477118,1004
2020-05-09,TX,37860,451434,489294,1049
2020-05-10,TX,38869,462907,501776,1088
2020-05-11,TX,39869,485828,525697,1100
2020-05-12,TX,41048,497124,538172,1133
2020-05-13,TX,42403,514373,556776,1158
2020-05-14,TX,43851,543462,587313,1216
2020-05-15,TX,45198,564432,609630,1272
2020-05-16,TX,46999,591740,638739,1305
2020-05-17,TX,47784,602571,650355,1336
2020-05-18,TX,48693,631152,679845,1347
2020-05-19,TX,49912,650234,700146,1369
2020-05-20,TX,51323,669605,720928,1419
2020-05-21,TX,52268,687913,740181,1440
2020-05-22,TX,53449,687913,741362,1480
2020-05-23,TX,54509,708197,762706,1506
2020-05-24,TX,55348,708197,763545,1506
2020-05-25,TX,55971,749683,805654,1527
2020-05-26,TX,56560,764673,821233,1536
2020-05-27,TX,57921,797753,855674,1562
2020-05-28,TX,59776,813442,873218,1601
2020-05-29,TX,61006,832269,893275,1626
2020-05-30,TX,62338,866179,928517,1626
2020-05-31,TX,64287,887578,951865,1672
2020-06-01,TX,64880,905151,970031,1678
2020-06-02,TX,66568,919656,986224,1698
2020-06-03,TX,68271,938497,1006768,1734
2020-06-04,TX,69920,968635,1038555,1767
2020-06-05,TX,71613,989963,1061576,1788
2020-06-06,TX,73553,1019724,1093277,1819
2020-06-07,TX,74978,1025468,1100446,1830
2020-06-08,TX,75616,1044700,1120316,1830
2020-06-09,TX,77253,1070102,1147355,1853
2020-06-10,TX,79757,1081330,1161087,1885
2020-06-11,TX,81583,1124737,1206320,1920
2020-06-12,TX,83680,1143277,1226957,1939
2020-06-13,TX,86011,1174308,1260319,1957
2020-06-14,TX,87854,1208129,1295983,1976
2020-06-15,TX,89108,1225653,1314761,1983
2020-06-16,TX,93206,1255236,1348442,2029
2020-06-17,TX,96335,1273303,1369638,2062
2020-06-18,TX,99851,1307890,1407741,2105
2020-06-19,TX,103305,1320609,1423914,2140
2020-06-20,TX,107735,1355663,1463398,2165
2020-06-21,TX,111601,1414579,1526180,2182
2020-06-22,TX,114881,1434128,1549009,2192
2020-06-23,TX,120370,1476920,1597290,2220
2020-06-24,TX,125921,1504337,1630258,2249
2020-06-25,TX,131917,1527423,1659340,2296
2020-06-26,TX,137624,1559710,1697334,2324
2020-06-27,TX,143371,1579455,1722826,2366
2020-06-28,TX,148728,1626491,1775219,2393
2020-06-29,TX,153011,1666178,1819189,2403
2020-06-30,TX,159986,1709296,1869282,2424
2020-07-01,TX,168062,1753886,1921948,2481
2020-07-02,TX,175977,1799826,1975803,2525
2020-07-03,TX,183532,1830374,2013906,2575
2020-07-04,TX,191790,1880019,2071809,2608
2020-07-05,TX,195239,1938218,2133457,2637
2020-07-06,TX,200557,1963172,2163729,2655
2020-07-07,TX,210585,2010702,2221287,2715
2020-07-08,TX,220564,2038144,2258708,2813
2020-07-09,TX,230346,2082866,2313212,2918
2020-07-10,TX,240111,2149678,2389789,3013
2020-07-11,TX,250462,2179162,2429624,3112
2020-07-12,TX,258658,2234096,2492754,3192
2020-07-13,TX,264313,2275812,2540125,3235
2020-07-14,TX,275058,2323622,2598680,3322
2020-07-15,TX,282365,2359834,2642199,3432
2020-07-16,TX,292656,2407199,2699855,3561
2020-07-17,TX,307572,2459749,2767321,3735
2020-07-18,TX,317730,2524955,2842685,3865
2020-07-19,TX,325030,2607334,2932364,3958
2020-07-20,TX,332434,2652120,2984554,4020
2020-07-21,TX,341739,2701835,3043574,4151
2020-07-22,TX,351618,2752530,3104148,4348
2020-07-23,TX,361125,2803531,3164656,4521
2020-07-24,TX,369826,2862105,3231931,4717
2020-07-25,TX,375846,2930196,3306042,4885
2020-03-07,UT,1,0,1,0
2020-03-08,UT,1,0,1,0
2020-03-09,UT,1,0,1,0
2020-03-10,UT,2,0,2,0
2020-03-11,UT,2,0,2,0
2020-03-12,UT,4,131,135,0
2020-03-13,UT,6,131,137,0
2020-03-14,UT,6,131,137,0
2020-03-15,UT,28,131,159,0
2020-03-16,UT,39,131,170,0
2020-03-17,UT,51,131,182,0
2020-03-18,UT,63,131,194,0
2020-03-19,UT,78,1448,1526,0
2020-03-20,UT,112,2035,2147,0
2020-03-21,UT,136,2424,2560,0
2020-03-22,UT,181,3508,3689,1
2020-03-23,UT,257,4790,5047,1
2020-03-24,UT,299,5524,5823,1
2020-03-25,UT,346,6491,6837,1
2020-03-26,UT,402,7308,7710,1
2020-03-27,UT,480,8764,9244,2
2020-03-28,UT,602,10710,11312,2
2020-03-29,UT,719,13274,13993,2
2020-03-30,UT,806,15197,16003,4
2020-03-31,UT,887,17626,18513,5
2020-04-01,UT,1012,20155,21167,7
2020-04-02,UT,1074,20155,21229,7
2020-04-03,UT,1246,23002,24248,7
2020-04-04,UT,1428,26615,28043,8
2020-04-05,UT,1605,29287,30892,8
2020-04-06,UT,1675,31719,33394,13
2020-04-07,UT,1738,32909,34647,13
2020-04-08,UT,1846,34270,36116,13
2020-04-09,UT,1976,36397,38373,13
2020-04-10,UT,2102,38660,40762,17
2020-04-11,UT,2206,40340,42546,18
2020-04-12,UT,2303,41931,44234,18
2020-04-13,UT,2363,43424,45787,18
2020-04-14,UT,2412,44064,46476,19
2020-04-15,UT,2542,45072,47614,20
2020-04-16,UT,2683,46995,49678,21
2020-04-17,UT,2805,52966,55771,23
2020-04-18,UT,2931,57013,59944,25
2020-04-19,UT,3069,60486,63555,27
2020-04-20,UT,3213,65098,68311,28
2020-04-21,UT,3296,69062,72358,32
2020-04-22,UT,3445,73015,76460,34
2020-04-23,UT,3612,77015,80627,35
2020-04-24,UT,3782,80915,84697,39
2020-04-25,UT,3948,86258,90206,41
2020-04-26,UT,4123,91579,95702,41
2020-04-27,UT,4233,95962,100195,41
2020-04-28,UT,4343,98096,102439,45
2020-04-29,UT,4495,101283,105778,45
2020-04-30,UT,4672,103829,108501,46
2020-05-01,UT,4828,107730,112558,46
2020-05-02,UT,4981,112823,117804,49
2020-05-03,UT,5175,116927,122102,50
2020-05-04,UT,5317,119344,124661,50
2020-05-05,UT,5449,121266,126715,56
2020-05-06,UT,5595,125407,131002,58
2020-05-07,UT,5724,128819,134543,61
2020-05-08,UT,5919,132769,138688,61
2020-05-09,UT,6103,137191,143294,66
2020-05-10,UT,6251,140259,146510,67
2020-05-11,UT,6362,144223,150585,68
2020-05-12,UT,6432,147053,153485,73
2020-05-13,UT,6620,150166,156786,75
2020-05-14,UT,6749,153370,160119,75
2020-05-15,UT,6913,156305,163218,77
2020-05-16,UT,7068,159706,166774,78
2020-05-17,UT,7238,163514,170752,80
2020-05-18,UT,7384,166638,174022,80
2020-05-19,UT,7518,169793,177311,88
2020-05-20,UT,7710,171954,179664,90
2020-05-21,UT,7874,175000,182874,92
2020-05-22,UT,8057,178777,186834,93
2020-05-23,UT,8260,182519,190779,97
2020-05-24,UT,8392,186041,194433,97
2020-05-25,UT,8521,187947,196468,98
2020-05-26,UT,8620,189972,198592,101
2020-05-27,UT,8706,191920,200626,105
2020-05-28,UT,8921,194586,203507,106
2020-05-29,UT,9264,196591,205855,107
2020-05-30,UT,9533,200572,210105,112
2020-05-31,UT,9797,204117,213914,113
2020-06-01,UT,9999,208113,218112,113
2020-06-02,UT,10202,211589,221791,113
2020-06-03,UT,10497,213484,223981,117
2020-06-04,UT,10813,216694,227507,117
2020-06-05,UT,11252,220945,232197,120
2020-06-06,UT,11798,223351,235149,121
2020-06-07,UT,12066,225885,237951,121
2020-06-08,UT,12322,230577,242899,124
2020-06-09,UT,12559,234301,246860,127
2020-06-10,UT,12864,236896,249760,128
2020-06-11,UT,13252,241416,254668,131
2020-06-12,UT,13577,245209,258786,139
2020-06-13,UT,13981,248801,262782,139
2020-06-14,UT,14313,253400,267713,139
2020-06-15,UT,14608,258330,272938,143
2020-06-16,UT,14937,260763,275700,145
2020-06-17,UT,15344,263348,278692,149
2020-06-18,UT,15839,266846,282685,152
2020-06-19,UT,16425,270933,287358,155
2020-06-20,UT,17068,275809,292877,155
2020-06-21,UT,17462,278933,296395,158
2020-06-22,UT,17906,281406,299312,158
2020-06-23,UT,18300,283976,302276,163
2020-06-24,UT,18784,285954,304738,163
2020-06-25,UT,19374,292680,312054,164
2020-06-26,UT,20050,297518,317568,166
2020-06-27,UT,20628,302174,322802,167
2020-06-28,UT,21100,307349,328449,167
2020-06-29,UT,21664,312241,333905,168
2020-06-30,UT,22217,318536,340753,172
2020-07-01,UT,22716,320642,343358,173
2020-07-02,UT,23270,323116,346386,176
2020-07-03,UT,23866,332770,356636,181
2020-07-04,UT,24542,342174,366716,181
2020-07-05,UT,24952,346356,371308,184
2020-07-06,UT,25469,350373,375842,190
2020-07-07,UT,26033,356816,382849,194
2020-07-08,UT,26755,359005,385760,201
2020-07-09,UT,27356,361377,388733,205
2020-07-10,UT,28223,367751,395974,207
2020-07-11,UT,28855,376497,405352,212
2020-07-12,UT,29484,383574,413058,215
2020-07-13,UT,30030,388305,418335,216
2020-07-14,UT,30478,394043,424521,226
2020-07-15,UT,30891,401189,432080,233
2020-07-16,UT,31845,407683,439528,234
2020-07-17,UT,32572,415234,447806,235
2020-07-18,UT,33332,422908,456240,243
2020-07-19,UT,34117,428705,462822,243
2020-07-20,UT,34526,434878,469404,247
2020-07-21,UT,35012,440431,475443,251
2020-07-22,UT,35578,445824,481402,260
2020-07-23,UT,36099,449323,485422,267
2020-07-24,UT,36962,457109,494071,273
2020-07-25,UT,37623,462516,500139,274
2020-03-05,VA,0,18,18,0
2020-03-06,VA,0,21,21,0
2020-03-07,VA,0,31,31,0
2020-03-08,VA,2,36,38,0
2020-03-09,VA,3,38,41,0
2020-03-10,VA,8,53,61,0
2020-03-11,VA,9,60,69,0
2020-03-12,VA,17,117,134,0
2020-03-13,VA,30,117,147,0
2020-03-14,VA,30,117,147,0
2020-03-15,VA,45,363,408,1
2020-03-16,VA,51,438,489,1
2020-03-17,VA,67,961,1028,1
2020-03-18,VA,77,1201,1278,1
2020-03-19,VA,94,1829,1923,2
2020-03-20,VA,114,2211,2325,2
2020-03-21,VA,152,2638,2790,2
2020-03-22,VA,219,3118,3337,3
2020-03-23,VA,254,3443,3697,6
2020-03-24,VA,290,4180,4470,7
2020-03-25,VA,391,4979,5370,9
2020-03-26,VA,460,5729,6189,13
2020-03-27,VA,604,6733,7337,14
2020-03-28,VA,739,8427,9166,17
2020-03-29,VA,890,9719,10609,22
2020-03-30,VA,1020,11018,12038,25
2020-03-31,VA,1250,12151,13401,27
2020-04-01,VA,1484,13860,15344,34
2020-04-02,VA,1706,15883,17589,41
2020-04-03,VA,2012,16993,19005,46
2020-04-04,VA,2407,19145,21552,52
2020-04-05,VA,2637,21034,23671,51
2020-04-06,VA,2878,21643,24521,54
2020-04-07,VA,3333,25312,28645,63
2020-04-08,VA,3645,27000,30645,75
2020-04-09,VA,4042,28984,33026,109
2020-04-10,VA,4509,30950,35459,121
2020-04-11,VA,5077,32922,37999,130
2020-04-12,VA,5274,34711,39985,141
2020-04-13,VA,5747,35654,41401,149
2020-04-14,VA,6171,36592,42763,154
2020-04-15,VA,6500,37669,44169,195
2020-04-16,VA,6889,39555,46444,208
2020-04-17,VA,7491,41506,48997,231
2020-04-18,VA,8053,43878,51931,258
2020-04-19,VA,8537,46196,54733,277
2020-04-20,VA,8990,47745,56735,300
2020-04-21,VA,9630,48724,58354,324
2020-04-22,VA,10266,50512,60778,349
2020-04-23,VA,10998,53891,64889,372
2020-04-24,VA,11594,57846,69440,410
2020-04-25,VA,12366,60276,72642,436
2020-04-26,VA,12970,63630,76600,448
2020-04-27,VA,13535,67144,80679,458
2020-04-28,VA,14339,68959,83298,492
2020-04-29,VA,14961,70979,85940,522
2020-04-30,VA,15846,75663,91509,552
2020-05-01,VA,16901,89539,106440,581
2020-05-02,VA,17731,84365,102096,616
2020-05-03,VA,18671,89331,108002,660
2020-05-04,VA,19492,92801,112293,684
2020-05-05,VA,20256,93452,113708,713
2020-05-06,VA,20256,93452,113708,713
2020-05-07,VA,21570,101582,123152,769
2020-05-08,VA,22342,107603,129945,812
2020-05-09,VA,23196,113953,137149,827
2020-05-10,VA,24081,118974,143055,839
2020-05-11,VA,25070,125547,150617,850
2020-05-12,VA,25800,129529,155329,891
2020-05-13,VA,26746,134646,161392,927
2020-05-14,VA,27813,139017,166830,955
2020-05-15,VA,28672,149342,178014,977
2020-05-16,VA,29683,155885,185568,1002
2020-05-17,VA,30388,159973,190361,1009
2020-05-18,VA,31140,165086,196226,1014
2020-05-19,VA,32145,170644,202789,1041
2020-05-20,VA,32908,179718,212626,1074
2020-05-21,VA,34137,184462,218599,1099
2020-05-22,VA,34950,190225,225175,1136
2020-05-23,VA,35749,196721,232470,1159
2020-05-24,VA,36244,207841,244085,1171
2020-05-25,VA,37727,221023,258750,1208
2020-05-26,VA,39342,227839,267181,1236
2020-05-27,VA,40249,236798,277047,1281
2020-05-28,VA,41401,245880,287281,1338
2020-05-29,VA,42533,255844,298377,1358
2020-05-30,VA,43611,261901,305512,1370
2020-05-31,VA,44607,270784,315391,1375
2020-06-01,VA,45398,279321,324719,1392
2020-06-02,VA,46239,282650,328889,1407
2020-06-03,VA,46905,295482,342387,1428
2020-06-04,VA,47856,305734,353590,1445
2020-06-05,VA,48532,315238,363770,1453
2020-06-06,VA,49397,321734,371131,1460
2020-06-07,VA,50681,329135,379816,1472
2020-06-08,VA,51251,332341,383592,1477
2020-06-09,VA,51738,339118,390856,1496
2020-06-10,VA,52177,346187,398364,1514
2020-06-11,VA,52647,354750,407397,1520
2020-06-12,VA,53211,397319,450530,1534
2020-06-13,VA,53869,406124,459993,1541
2020-06-14,VA,54506,414494,469000,1546
2020-06-15,VA,54886,424113,478999,1552
2020-06-16,VA,55331,430107,485438,1570
2020-06-17,VA,55775,438566,494341,1583
2020-06-18,VA,56238,445830,502068,1586
2020-06-19,VA,56793,455618,512411,1602
2020-06-20,VA,57443,473961,531404,1607
2020-06-21,VA,57994,487682,545676,1611
2020-06-22,VA,58465,499658,558123,1620
2020-06-23,VA,58994,509383,568377,1645
2020-06-24,VA,59514,517057,576571,1661
2020-06-25,VA,59946,533020,592966,1675
2020-06-26,VA,60570,545893,606463,1700
2020-06-27,VA,61247,556679,617926,1724
2020-06-28,VA,61736,566592,628328,1732
2020-06-29,VA,62189,574183,636372,1740
2020-06-30,VA,62787,582247,645034,1763
2020-07-01,VA,63203,595430,658633,1786
2020-07-02,VA,63735,610521,674256,1816
2020-07-03,VA,64393,623967,688360,1845
2020-07-04,VA,65109,634120,699229,1849
2020-07-05,VA,65748,643607,709355,1853
2020-07-06,VA,66102,649011,715113,1853
2020-07-07,VA,66740,661377,728117,1881
2020-07-08,VA,67375,670624,737999,1905
2020-07-09,VA,67988,685440,753428,1937
2020-07-10,VA,68931,699794,768725,1958
2020-07-11,VA,69782,716553,786335,1962
2020-07-12,VA,70670,733375,804045,1966
2020-07-13,VA,71642,742373,814015,1968
2020-07-14,VA,72443,758407,830850,1977
2020-07-15,VA,73527,771455,844982,1992
2020-07-16,VA,74431,786742,861173,2007
2020-07-17,VA,75433,801271,876704,2013
2020-07-18,VA,76373,813328,889701,2025
2020-07-19,VA,77430,829933,907363,2027
2020-07-20,VA,78375,842086,920461,2031
2020-07-21,VA,79371,860721,940092,2048
2020-07-22,VA,80393,873794,954187,2051
2020-07-23,VA,81237,890963,972200,2054
2020-07-24,VA,82364,907935,990299,2067
2020-07-25,VA,83609,926834,1010443,2075
2020-03-16,VI,1,0,1,0
2020-03-17,VI,2,0,2,0
2020-03-18,VI,2,0,2,0
2020-03-19,VI,3,0,3,0
2020-03-20,VI,3,0,3,0
2020-03-21,VI,6,0,6,0
2020-03-22,VI,6,0,6,0
2020-03-23,VI,17,0,17,0
2020-03-24,VI,17,0,17,0
2020-03-25,VI,17,55,72,0
2020-03-26,VI,17,55,72,0
2020-03-27,VI,19,55,74,0
2020-03-28,VI,22,106,128,0
2020-03-29,VI,23,123,146,0
2020-03-30,VI,30,126,156,0
2020-03-31,VI,30,126,156,0
2020-04-01,VI,30,126,156,0
2020-04-02,VI,33,149,182,0
2020-04-03,VI,38,154,192,0
2020-04-04,VI,40,184,224,0
2020-04-05,VI,42,206,248,1
2020-04-06,VI,43,222,265,1
2020-04-07,VI,43,222,265,1
2020-04-08,VI,45,242,287,1
2020-04-09,VI,46,251,297,1
2020-04-10,VI,50,273,323,1
2020-04-11,VI,51,299,350,1
2020-04-12,VI,51,299,350,1
2020-04-13,VI,51,322,373,1
2020-04-14,VI,51,326,377,1
2020-04-15,VI,51,331,382,1
2020-04-16,VI,51,357,408,1
2020-04-17,VI,51,373,424,2
2020-04-18,VI,53,390,443,3
2020-04-19,VI,53,548,601,3
2020-04-20,VI,53,554,607,3
2020-04-21,VI,54,574,628,3
2020-04-22,VI,54,583,637,3
2020-04-23,VI,54,583,637,3
2020-04-24,VI,54,642,696,3
2020-04-25,VI,55,693,748,3
2020-04-26,VI,57,700,757,4
2020-04-27,VI,59,716,775,4
2020-04-28,VI,59,719,778,4
2020-04-29,VI,62,732,794,4
2020-04-30,VI,66,807,873,4
2020-05-01,VI,66,811,877,4
2020-05-02,VI,66,922,988,4
2020-05-03,VI,66,951,1017,4
2020-05-04,VI,66,965,1031,4
2020-05-05,VI,66,973,1039,4
2020-05-06,VI,66,990,1056,4
2020-05-07,VI,66,990,1056,4
2020-05-08,VI,68,1024,1092,4
2020-05-09,VI,68,1024,1092,4
2020-05-10,VI,69,1102,1171,4
2020-05-11,VI,69,1110,1179,5
2020-05-12,VI,69,1115,1184,6
2020-05-13,VI,69,1128,1197,6
2020-05-14,VI,69,1164,1233,6
2020-05-15,VI,69,1194,1263,6
2020-05-16,VI,69,1194,1263,6
2020-05-17,VI,69,1278,1347,6
2020-05-18,VI,69,1278,1347,6
2020-05-19,VI,69,1298,1367,6
2020-05-20,VI,69,1314,1383,6
2020-05-21,VI,69,1314,1383,6
2020-05-22,VI,69,1343,1412,6
2020-05-23,VI,69,1343,1412,6
2020-05-24,VI,69,1343,1412,6
2020-05-25,VI,69,1343,1412,6
2020-05-26,VI,69,1425,1494,6
2020-05-27,VI,69,1442,1511,6
2020-05-28,VI,69,1617,1686,6
2020-05-29,VI,69,1633,1702,6
2020-05-30,VI,69,1633,1702,6
2020-05-31,VI,69,1633,1702,6
2020-06-01,VI,70,1741,1811,6
2020-06-02,VI,70,1936,2006,6
2020-06-03,VI,70,1956,2026,6
2020-06-04,VI,71,1975,2046,6
2020-06-05,VI,71,1980,2051,6
2020-06-06,VI,71,2125,2196,6
2020-06-07,VI,71,2125,2196,6
2020-06-08,VI,71,2128,2199,6
2020-06-09,VI,71,2137,2208,6
2020-06-10,VI,72,2169,2241,6
2020-06-11,VI,72,2180,2252,6
2020-06-12,VI,72,2221,2293,6
2020-06-13,VI,72,2284,2356,6
2020-06-14,VI,72,2305,2377,6
2020-06-15,VI,73,2305,2378,6
2020-06-16,VI,73,2305,2378,6
2020-06-17,VI,73,2354,2427,6
2020-06-18,VI,73,2354,2427,6
2020-06-19,VI,74,2450,2524,6
2020-06-20,VI,74,2492,2566,6
2020-06-21,VI,76,2502,2578,6
2020-06-22,VI,76,2502,2578,6
2020-06-23,VI,76,2544,2620,6
2020-06-24,VI,78,2593,2671,6
2020-06-25,VI,80,2654,2734,6
2020-06-26,VI,81,2705,2786,6
2020-06-27,VI,81,2746,2827,6
2020-06-28,VI,81,2746,2827,6
2020-06-29,VI,81,2746,2827,6
2020-06-30,VI,84,2819,2903,6
2020-07-01,VI,90,2876,2966,6
2020-07-02,VI,92,2924,3016,6
2020-07-03,VI,98,2963,3061,6
2020-07-04,VI,111,3060,3171,6
2020-07-05,VI,111,3060,3171,6
2020-07-06,VI,112,3118,3230,6
2020-07-07,VI,116,3183,3299,6
2020-07-08,VI,122,3273,3395,6
2020-07-09,VI,144,3370,3514,6
2020-07-10,VI,153,3473,3626,6
2020-07-11,VI,167,3640,3807,6
2020-07-12,VI,181,3908,4089,6
2020-07-13,VI,206,4084,4290,6
2020-07-14,VI,206,4084,4290,6
2020-07-15,VI,243,4637,4880,6
2020-07-16,VI,249,5036,5285,6
2020-07-17,VI,263,5790,6053,6
2020-07-18,VI,283,6239,6522,6
2020-07-19,VI,297,6587,6884,6
2020-07-20,VI,304,6617,6921,6
2020-07-21,VI,308,6853,7161,6
2020-07-22,VI,320,7146,7466,7
2020-07-23,VI,336,7500,7836,7
2020-07-24,VI,336,7500,7836,7
2020-07-25,VI,352,7901,8253,7
2020-03-06,VT,0,0,0,0
2020-03-07,VT,1,25,26,0
2020-03-08,VT,1,30,31,0
2020-03-09,VT,1,36,37,0
2020-03-10,VT,1,60,61,0
2020-03-11,VT,2,91,93,0
2020-03-12,VT,2,136,138,0
2020-03-13,VT,5,223,228,0
2020-03-14,VT,8,332,340,0
2020-03-15,VT,12,405,417,0
2020-03-16,VT,17,487,504,0
2020-03-17,VT,19,581,600,0
2020-03-18,VT,21,637,658,0
2020-03-19,VT,28,764,792,0
2020-03-20,VT,44,957,1001,2
2020-03-21,VT,52,1080,1132,2
2020-03-22,VT,76,1204,1280,2
2020-03-23,VT,97,1424,1521,5
2020-03-24,VT,125,1569,1694,7
2020-03-25,VT,160,1810,1970,8
2020-03-26,VT,185,2744,2929,9
2020-03-27,VT,213,2868,3081,10
2020-03-28,VT,234,3192,3426,12
2020-03-29,VT,256,3483,3739,12
2020-03-30,VT,293,3718,4011,12
2020-03-31,VT,320,3949,4269,13
2020-04-01,VT,359,4162,4521,16
2020-04-02,VT,390,4384,4774,17
2020-04-03,VT,460,4865,5325,17
2020-04-04,VT,512,5242,5754,20
2020-04-05,VT,543,5830,6373,22
2020-04-06,VT,575,6161,6736,23
2020-04-07,VT,608,6645,7253,23
2020-04-08,VT,631,7001,7632,23
2020-04-09,VT,680,7218,7898,23
2020-04-10,VT,713,7502,8215,24
2020-04-11,VT,733,8063,8796,25
2020-04-12,VT,754,8724,9478,27
2020-04-13,VT,761,9275,10036,28
2020-04-14,VT,770,9491,10261,29
2020-04-15,VT,779,9913,10692,30
2020-04-16,VT,792,10259,11051,35
2020-04-17,VT,802,10813,11615,35
2020-04-18,VT,813,11212,12025,38
2020-04-19,VT,817,11450,12267,38
2020-04-20,VT,820,11671,12491,38
2020-04-21,VT,828,11767,12595,40
2020-04-22,VT,831,12097,12928,40
2020-04-23,VT,834,12420,13254,43
2020-04-24,VT,843,12808,13651,44
2020-04-25,VT,852,13270,14122,46
2020-04-26,VT,855,13518,14373,46
2020-04-27,VT,862,13819,14681,47
2020-04-28,VT,862,13947,14809,47
2020-04-29,VT,866,14155,15021,47
2020-04-30,VT,879,14357,15236,49
2020-05-01,VT,885,14930,15815,50
2020-05-02,VT,896,15232,16128,51
2020-05-03,VT,901,15570,16471,52
2020-05-04,VT,906,15889,16795,52
2020-05-05,VT,909,16065,16974,52
2020-05-06,VT,914,16281,17195,52
2020-05-07,VT,916,16690,17606,53
2020-05-08,VT,918,17222,18140,53
2020-05-09,VT,926,17690,18616,53
2020-05-10,VT,926,18167,19093,53
2020-05-11,VT,927,18797,19724,53
2020-05-12,VT,929,19107,20036,53
2020-05-13,VT,930,19708,20638,53
2020-05-14,VT,931,20497,21428,53
2020-05-15,VT,932,21237,22169,53
2020-05-16,VT,940,22197,23137,53
2020-05-17,VT,940,22974,23914,54
2020-05-18,VT,944,23547,24491,54
2020-05-19,VT,944,24114,25058,54
2020-05-20,VT,944,24114,25058,54
2020-05-21,VT,950,24751,25701,54
2020-05-22,VT,952,24781,25733,54
2020-05-23,VT,954,26470,27424,54
2020-05-24,VT,956,27634,28590,54
2020-05-25,VT,962,28707,29669,54
2020-05-26,VT,967,29456,30423,54
2020-05-27,VT,971,30028,30999,54
2020-05-28,VT,974,30178,31152,55
2020-05-29,VT,975,30910,31885,55
2020-05-30,VT,977,31690,32667,55
2020-05-31,VT,981,32989,33970,55
2020-06-01,VT,983,34343,35326,55
2020-06-02,VT,988,35631,36619,55
2020-06-03,VT,990,36205,37195,55
2020-06-04,VT,1026,36808,37834,55
2020-06-05,VT,1027,38090,39117,55
2020-06-06,VT,1046,39037,40083,55
2020-06-07,VT,1063,40155,41218,55
2020-06-08,VT,1075,41723,42798,55
2020-06-09,VT,1084,43144,44228,55
2020-06-10,VT,1095,44647,45742,55
2020-06-11,VT,1110,46099,47209,55
2020-06-12,VT,1119,47515,48634,55
2020-06-13,VT,1125,48808,49933,55
2020-06-14,VT,1127,49855,50982,55
2020-06-15,VT,1128,51429,52557,55
2020-06-16,VT,1131,51759,52890,55
2020-06-17,VT,1130,52533,53663,55
2020-06-18,VT,1135,53610,54745,56
2020-06-19,VT,1144,54743,55887,56
2020-06-20,VT,1147,55881,57028,56
2020-06-21,VT,1159,56686,57845,56
2020-06-22,VT,1163,57444,58607,56
2020-06-23,VT,1164,58164,59328,56
2020-06-24,VT,1184,58676,59860,56
2020-06-25,VT,1191,59518,60709,56
2020-06-26,VT,1198,60391,61589,56
2020-06-27,VT,1200,61523,62723,56
2020-06-28,VT,1202,62663,63865,56
2020-06-29,VT,1208,63785,64993,56
2020-06-30,VT,1208,64556,65764,56
2020-07-01,VT,1210,65082,66292,56
2020-07-02,VT,1227,66114,67341,56
2020-07-03,VT,1236,67159,68395,56
2020-07-04,VT,1238,68159,69397,56
2020-07-05,VT,1249,68775,70024,56
2020-07-06,VT,1251,69102,70353,56
2020-07-07,VT,1254,69859,71113,56
2020-07-08,VT,1256,70500,71756,56
2020-07-09,VT,1272,71477,72749,56
2020-07-10,VT,1277,72821,74098,56
2020-07-11,VT,1283,73749,75032,56
2020-07-12,VT,1296,74555,75851,56
2020-07-13,VT,1301,75280,76581,56
2020-07-14,VT,1305,76319,77624,56
2020-07-15,VT,1318,77040,78358,56
2020-07-16,VT,1325,77715,79040,56
2020-07-17,VT,1334,78032,79366,56
2020-07-18,VT,1338,79108,80446,56
2020-07-19,VT,1350,81150,82500,56
2020-07-20,VT,1360,82508,83868,56
2020-07-21,VT,1366,83581,84947,56
2020-07-22,VT,1366,84376,85742,56
2020-07-23,VT,1377,85205,86582,56
2020-07-24,VT,1385,86307,87692,56
2020-07-25,VT,1396,87420,88816,56
2020-01-22,WA,2,0,2,0
2020-01-23,WA,2,0,2,0
2020-01-24,WA,2,0,2,0
2020-01-25,WA,2,0,2,0
2020-01-26,WA,2,0,2,0
2020-01-27,WA,2,0,2,0
2020-01-28,WA,2,0,2,0
2020-01-29,WA,3,0,3,0
2020-01-30,WA,3,0,3,0
2020-01-31,WA,3,0,3,0
2020-02-01,WA,4,0,4,0
2020-02-02,WA,6,0,6,0
2020-02-03,WA,7,0,7,0
2020-02-04,WA,8,0,8,0
2020-02-05,WA,8,0,8,0
2020-02-06,WA,11,0,11,0
2020-02-07,WA,12,0,12,0
2020-02-08,WA,13,0,13,0
2020-02-09,WA,13,0,13,0
2020-02-10,WA,16,0,16,0
2020-02-11,WA,17,0,17,0
2020-02-12,WA,18,0,18,0
2020-02-13,WA,18,0,18,0
2020-02-14,WA,21,0,21,0
2020-02-15,WA,28,0,28,0
2020-02-16,WA,35,0,35,0
2020-02-17,WA,50,0,50,0
2020-02-18,WA,59,0,59,0
2020-02-19,WA,69,0,69,0
2020-02-20,WA,82,0,82,0
2020-02-21,WA,93,0,93,0
2020-02-22,WA,106,0,106,0
2020-02-23,WA,122,0,122,0
2020-02-24,WA,148,0,148,0
2020-02-25,WA,179,0,179,0
2020-02-26,WA,208,0,208,2
2020-02-27,WA,235,0,235,2
2020-02-28,WA,275,0,275,4
2020-02-29,WA,299,17,316,5
2020-03-01,WA,377,12,389,8
2020-03-02,WA,450,123,573,11
2020-03-03,WA,534,264,798,14
2020-03-04,WA,626,417,1043,16
2020-03-05,WA,731,672,1403,20
2020-03-06,WA,813,1066,1879,26
2020-03-07,WA,912,1370,2282,27
2020-03-08,WA,1065,1740,2805,31
2020-03-09,WA,1237,2592,3829,35
2020-03-10,WA,1453,4160,5613,37
2020-03-11,WA,1665,6215,7880,40
2020-03-12,WA,1921,9723,11644,44
2020-03-13,WA,2218,13660,15878,47
2020-03-14,WA,2484,15723,18207,51
2020-03-15,WA,2738,17158,19896,57
2020-03-16,WA,3107,21684,24791,69
2020-03-17,WA,3432,25997,29429,78
2020-03-18,WA,3810,30359,34169,82
2020-03-19,WA,4146,34573,38719,92
2020-03-20,WA,4551,38229,42780,104
2020-03-21,WA,4837,40285,45122,111
2020-03-22,WA,5121,41889,47010,126
2020-03-23,WA,5568,46745,52313,137
2020-03-24,WA,5923,51617,57540,146
2020-03-25,WA,6329,56218,62547,159
2020-03-26,WA,6700,60318,67018,183
2020-03-27,WA,7076,64302,71378,199
2020-03-28,WA,7397,66582,73979,220
2020-03-29,WA,7715,68097,75812,237
2020-03-30,WA,8120,72842,80962,248
2020-03-31,WA,8431,77237,85668,262
2020-04-01,WA,8869,81516,90385,282
2020-04-02,WA,9201,86091,95292,310
2020-04-03,WA,9485,90661,100146,338
2020-04-04,WA,9732,93028,102760,365
2020-04-05,WA,9953,94759,104712,386
2020-04-06,WA,10282,99566,109848,407
2020-04-07,WA,10547,104530,115077,429
2020-04-08,WA,10831,109050,119881,443
2020-04-09,WA,11118,113069,124187,459
2020-04-10,WA,11395,117091,128486,476
2020-04-11,WA,11605,118957,130562,494
2020-04-12,WA,11775,120218,131993,509
2020-04-13,WA,12079,124134,136213,526
2020-04-14,WA,12303,128219,140522,542
2020-04-15,WA,12619,132049,144668,551
2020-04-16,WA,12872,136144,149016,571
2020-04-17,WA,13174,140294,153468,585
2020-04-18,WA,13407,142307,155714,598
2020-04-19,WA,13583,143808,157391,615
2020-04-20,WA,13890,147889,161779,629
2020-04-21,WA,14133,151848,165981,640
2020-04-22,WA,14375,156030,170405,647
2020-04-23,WA,14628,160115,174743,654
2020-04-24,WA,14913,165339,180252,659
2020-04-25,WA,15110,168153,183263,665
2020-04-26,WA,15292,169749,185041,738
2020-04-27,WA,15566,174592,190158,749
2020-04-28,WA,15798,179707,195505,765
2020-04-29,WA,16042,184386,200428,786
2020-04-30,WA,16309,189001,205310,801
2020-05-01,WA,16653,193449,210102,814
2020-05-02,WA,16802,195619,212421,824
2020-05-03,WA,16943,196962,213905,830
2020-05-04,WA,17209,202206,219415,834
2020-05-05,WA,17470,207014,224484,841
2020-05-06,WA,17718,212065,229783,862
2020-05-07,WA,17914,216453,234367,870
2020-05-08,WA,18124,221418,239542,891
2020-05-09,WA,18275,223361,241636,905
2020-05-10,WA,18449,224548,242997,921
2020-05-11,WA,18741,229099,247840,931
2020-05-12,WA,18952,233864,252816,945
2020-05-13,WA,19179,238384,257563,962
2020-05-14,WA,19424,243144,262568,975
2020-05-15,WA,19650,248322,267972,983
2020-05-16,WA,19838,250963,270801,992
2020-05-17,WA,19991,252780,272771,1000
2020-05-18,WA,20286,259467,279753,1001
2020-05-19,WA,20535,266314,286849,1002
2020-05-20,WA,20784,271703,292487,1031
2020-05-21,WA,20988,276171,297159,1037
2020-05-22,WA,21283,280444,301727,1044
2020-05-23,WA,21492,282906,304398,1050
2020-05-24,WA,21652,285088,306740,1055
2020-05-25,WA,21909,287314,309223,1061
2020-05-26,WA,22184,293934,316118,1070
2020-05-27,WA,22483,299378,321861,1078
2020-05-28,WA,22753,304340,327093,1095
2020-05-29,WA,23047,309438,332485,1106
2020-05-30,WA,23275,312508,335783,1111
2020-05-31,WA,23456,314671,338127,1118
2020-06-01,WA,23798,320527,344325,1118
2020-06-02,WA,24086,326646,350732,1124
2020-06-03,WA,24385,331675,356060,1129
2020-06-04,WA,24677,335972,360649,1135
2020-06-05,WA,25023,341885,366908,1138
2020-06-06,WA,25227,345430,370657,1149
2020-06-07,WA,25419,347610,373029,1153
2020-06-08,WA,25732,355573,381305,1159
2020-06-09,WA,26004,365086,391090,1161
2020-06-10,WA,26281,376364,402645,1176
2020-06-11,WA,26559,387295,413854,1190
2020-06-12,WA,26825,396220,423045,1194
2020-06-13,WA,26985,402149,429134,1204
2020-06-14,WA,27095,405799,432894,1213
2020-06-15,WA,27493,416076,443569,1217
2020-06-16,WA,27925,426586,454511,1221
2020-06-17,WA,28255,435169,463424,1231
2020-06-18,WA,28575,441468,470043,1226
2020-06-19,WA,28666,445796,474462,1245
2020-06-20,WA,28680,446471,475151,1255
2020-06-21,WA,28225,437844,466069,1265
2020-06-22,WA,28680,446258,474938,1270
2020-06-23,WA,28870,448334,477204,1276
2020-06-24,WA,29386,457673,487059,1284
2020-06-25,WA,29869,465629,495498,1293
2020-06-26,WA,30367,475428,505795,1300
2020-06-27,WA,30855,483573,514428,1304
2020-06-28,WA,31404,494398,525802,1310
2020-06-29,WA,31752,502691,534443,1310
2020-06-30,WA,32253,515967,548220,1320
2020-07-01,WA,32824,524451,557275,1332
2020-07-02,WA,33435,538529,571964,1339
2020-07-03,WA,34151,550838,584989,1342
2020-07-04,WA,34778,565197,599975,1352
2020-07-05,WA,35247,572029,607276,1354
2020-07-06,WA,35898,576808,612706,1359
2020-07-07,WA,36985,592271,629256,1370
2020-07-08,WA,37420,598104,635524,1384
2020-07-09,WA,37941,607131,645072,1394
2020-07-10,WA,38581,621749,660330,1409
2020-07-11,WA,39218,629248,668466,1424
2020-07-12,WA,39218,629248,668466,1424
2020-07-13,WA,40656,645349,686005,1438
2020-07-14,WA,41757,666517,708274,1399
2020-07-15,WA,42304,675930,718234,1404
2020-07-16,WA,43046,690840,733886,1421
2020-07-17,WA,44313,708861,753174,1427
2020-07-18,WA,45067,722590,767657,1434
2020-07-19,WA,46026,745760,791786,1444
2020-07-20,WA,46946,762393,809339,1447
2020-07-21,WA,47743,778611,826354,1453
2020-07-22,WA,48575,792609,841184,1465
2020-07-23,WA,49247,805905,855152,1468
2020-07-24,WA,50009,820754,870763,1482
2020-07-25,WA,50824,833158,883982,1495
2020-03-04,WI,1,19,20,0
2020-03-05,WI,1,19,20,0
2020-03-06,WI,1,31,32,0
2020-03-07,WI,1,31,32,0
2020-03-08,WI,1,31,32,0
2020-03-09,WI,1,36,37,0
2020-03-10,WI,2,36,38,0
2020-03-11,WI,3,43,46,0
2020-03-12,WI,9,84,93,0
2020-03-13,WI,23,169,192,0
2020-03-14,WI,23,169,192,0
2020-03-15,WI,37,313,350,0
2020-03-16,WI,56,504,560,0
2020-03-17,WI,83,1038,1121,0
2020-03-18,WI,121,1577,1698,0
2020-03-19,WI,174,2192,2366,0
2020-03-20,WI,235,3455,3690,3
2020-03-21,WI,315,4628,4943,4
2020-03-22,WI,425,6230,6655,4
2020-03-23,WI,466,7050,7516,5
2020-03-24,WI,525,8237,8762,5
2020-03-25,WI,667,10089,10756,7
2020-03-26,WI,806,11583,12389,8
2020-03-27,WI,969,13140,14109,13
2020-03-28,WI,1134,15232,16366,13
2020-03-29,WI,1276,16550,17826,13
2020-03-30,WI,1422,15856,17278,14
2020-03-31,WI,1585,17375,18960,16
2020-04-01,WI,1821,18819,20640,24
2020-04-02,WI,2040,20317,22357,31
2020-04-03,WI,2263,22377,24640,37
2020-04-04,WI,2476,23859,26335,56
2020-04-05,WI,2643,25169,27812,68
2020-04-06,WI,2866,26574,29440,77
2020-04-07,WI,3064,28512,31576,92
2020-04-08,WI,3279,30115,33394,99
2020-04-09,WI,3443,31424,34867,111
2020-04-10,WI,3665,33225,36890,128
2020-04-11,WI,3822,34680,38502,137
2020-04-12,WI,3964,35916,39880,144
2020-04-13,WI,4080,36769,40849,154
2020-04-14,WI,4246,37997,42243,170
2020-04-15,WI,4453,39326,43779,182
2020-04-16,WI,4636,40974,45610,197
2020-04-17,WI,4839,42365,47204,205
2020-04-18,WI,5013,43962,48975,211
2020-04-19,WI,5176,45323,50499,220
2020-04-20,WI,5353,46603,51956,230
2020-04-21,WI,5509,47841,53350,242
2020-04-22,WI,5766,49502,55268,246
2020-04-23,WI,6011,51456,57467,257
2020-04-24,WI,6364,54573,60937,262
2020-04-25,WI,6715,57138,63853,266
2020-04-26,WI,6963,59235,66198,272
2020-04-27,WI,7161,61311,68472,281
2020-04-28,WI,7391,63535,70926,300
2020-04-29,WI,7660,66630,74290,308
2020-04-30,WI,8052,69394,77446,316
2020-05-01,WI,8550,72566,81116,327
2020-05-02,WI,8920,75570,84490,334
2020-05-03,WI,9227,77997,87224,339
2020-05-04,WI,9538,80467,90005,340
2020-05-05,WI,9896,83967,93863,353
2020-05-06,WI,10262,87826,98088,362
2020-05-07,WI,10621,93035,103656,374
2020-05-08,WI,11030,97265,108295,384
2020-05-09,WI,11402,101935,113337,398
2020-05-10,WI,11694,105163,116857,400
2020-05-11,WI,11920,108033,119953,409
2020-05-12,WI,12131,112748,124879,418
2020-05-13,WI,12449,117111,129560,421
2020-05-14,WI,12869,122598,135467,434
2020-05-15,WI,13344,128657,142001,445
2020-05-16,WI,13878,134206,148084,453
2020-05-17,WI,14257,139674,153931,453
2020-05-18,WI,14442,144502,158944,459
2020-05-19,WI,14692,148237,162929,467
2020-05-20,WI,15269,154300,169569,481
2020-05-21,WI,15792,163238,179030,487
2020-05-22,WI,16340,172703,189043,496
2020-05-23,WI,16843,179329,196172,507
2020-05-24,WI,17253,186206,203459,510
2020-05-25,WI,17571,193379,210950,514
2020-05-26,WI,17867,200874,218741,517
2020-05-27,WI,18513,210605,229118,539
2020-05-28,WI,19077,220719,239796,550
2020-05-29,WI,19843,233588,253431,568
2020-05-30,WI,20382,242908,263290,588
2020-05-31,WI,20564,250103,270667,592
2020-06-01,WI,20736,253595,274331,595
2020-06-02,WI,21155,263743,284898,607
2020-06-03,WI,21661,279711,301372,616
2020-06-04,WI,22193,291367,313560,626
2020-06-05,WI,22599,303332,325931,633
2020-06-06,WI,22937,314802,337739,645
2020-06-07,WI,23212,325867,349079,647
2020-06-08,WI,23434,333253,356687,646
2020-06-09,WI,23734,347210,370944,661
2020-06-10,WI,24070,357112,381182,671
2020-06-11,WI,24441,366054,390495,682
2020-06-12,WI,24795,377362,402157,689
2020-06-13,WI,25089,388399,413488,691
2020-06-14,WI,25340,397366,422706,692
2020-06-15,WI,25546,403447,428993,694
2020-06-16,WI,25844,414330,440174,703
2020-06-17,WI,26129,423736,449865,712
2020-06-18,WI,26590,433913,460503,719
2020-06-19,WI,26913,444751,471664,730
2020-06-20,WI,27326,454563,481889,744
2020-06-21,WI,27615,460334,487949,744
2020-06-22,WI,27878,466634,494512,745
2020-06-23,WI,28175,478165,506340,750
2020-06-24,WI,28641,487803,516444,757
2020-06-25,WI,29105,498561,527666,766
2020-06-26,WI,29668,507168,536836,766
2020-06-27,WI,30227,515723,545950,777
2020-06-28,WI,30707,521747,552454,777
2020-06-29,WI,31033,527359,558392,784
2020-06-30,WI,31662,539539,571201,784
2020-07-01,WI,32225,551607,583832,793
2020-07-02,WI,32809,563946,596755,800
2020-07-03,WI,33431,573553,606984,803
2020-07-04,WI,34207,579637,613844,803
2020-07-05,WI,34740,584111,618851,803
2020-07-06,WI,35230,588913,624143,803
2020-07-07,WI,35765,601012,636777,812
2020-07-08,WI,36410,611150,647560,814
2020-07-09,WI,37210,623554,660764,816
2020-07-10,WI,38099,635411,673510,821
2020-07-11,WI,39080,646504,685584,828
2020-07-12,WI,39877,653352,693229,827
2020-07-13,WI,40382,659479,699861,827
2020-07-14,WI,41349,673195,714544,833
2020-07-15,WI,42197,686299,728496,834
2020-07-16,WI,43139,699670,742809,838
2020-07-17,WI,44068,712197,756265,840
2020-07-18,WI,45099,723643,768742,850
2020-07-19,WI,45948,730902,776850,851
2020-07-20,WI,46675,737191,783866,853
2020-07-21,WI,47836,750562,798398,866
2020-07-22,WI,48583,764630,813213,872
2020-07-23,WI,49669,778842,828511,885
2020-07-24,WI,50727,795280,846007,885
2020-07-25,WI,51715,808528,860243,898
2020-03-06,WV,0,1,1,0
2020-03-07,WV,0,2,2,0
2020-03-08,WV,0,2,2,0
2020-03-09,WV,0,2,2,0
2020-03-10,WV,0,2,2,0
2020-03-11,WV,0,3,3,0
2020-03-12,WV,0,7,7,0
2020-03-13,WV,0,17,17,0
2020-03-14,WV,0,26,26,0
2020-03-15,WV,0,38,38,0
2020-03-16,WV,0,80,80,0
2020-03-17,WV,0,80,80,0
2020-03-18,WV,1,122,123,0
2020-03-19,WV,2,143,145,0
2020-03-20,WV,7,219,226,0
2020-03-21,WV,11,330,341,0
2020-03-22,WV,12,385,397,0
2020-03-23,WV,16,444,460,0
2020-03-24,WV,20,610,630,0
2020-03-25,WV,39,759,798,0
2020-03-26,WV,51,1031,1082,0
2020-03-27,WV,76,1779,1855,0
2020-03-28,WV,96,2331,2427,0
2020-03-29,WV,113,2705,2818,0
2020-03-30,WV,126,2984,3110,1
2020-03-31,WV,162,3981,4143,1
2020-04-01,WV,191,4384,4575,1
2020-04-02,WV,217,5276,5493,2
2020-04-03,WV,237,6130,6367,2
2020-04-04,WV,282,7404,7686,2
2020-04-05,WV,324,8514,8838,3
2020-04-06,WV,345,9595,9940,4
2020-04-07,WV,412,11647,12059,4
2020-04-08,WV,462,12083,12545,4
2020-04-09,WV,523,13340,13863,5
2020-04-10,WV,554,14001,14555,5
2020-04-11,WV,577,14875,15452,5
2020-04-12,WV,611,15646,16257,8
2020-04-13,WV,626,16029,16655,9
2020-04-14,WV,640,16398,17038,9
2020-04-15,WV,702,16954,17656,10
2020-04-16,WV,739,17567,18306,13
2020-04-17,WV,754,17927,18681,13
2020-04-18,WV,785,18655,19440,16
2020-04-19,WV,863,19168,20031,18
2020-04-20,WV,902,21253,22155,24
2020-04-21,WV,914,21849,22763,26
2020-04-22,WV,939,24897,25836,26
2020-04-23,WV,967,26938,27905,29
2020-04-24,WV,988,28823,29811,32
2020-04-25,WV,1020,31946,32966,32
2020-04-26,WV,1044,38019,39063,34
2020-04-27,WV,1063,41976,43039,36
2020-04-28,WV,1079,41976,43055,37
2020-04-29,WV,1095,41976,43071,38
2020-04-30,WV,1118,43423,44541,41
2020-05-01,WV,1136,45708,46844,46
2020-05-02,WV,1169,47977,49146,48
2020-05-03,WV,1191,50447,51638,50
2020-05-04,WV,1206,52033,53239,50
2020-05-05,WV,1238,53585,54823,50
2020-05-06,WV,1248,54536,55784,50
2020-05-07,WV,1287,56234,57521,51
2020-05-08,WV,1310,58126,59436,51
2020-05-09,WV,1335,59662,60997,53
2020-05-10,WV,1360,61284,62644,54
2020-05-11,WV,1366,62103,63469,54
2020-05-12,WV,1371,63698,65069,57
2020-05-13,WV,1398,65282,66680,58
2020-05-14,WV,1427,67286,68713,60
2020-05-15,WV,1441,69495,70936,62
2020-05-16,WV,1457,71936,73393,64
2020-05-17,WV,1490,74000,75490,67
2020-05-18,WV,1491,74544,76035,67
2020-05-19,WV,1509,76792,78301,68
2020-05-20,WV,1545,79096,80641,69
2020-05-21,WV,1593,81548,83141,70
2020-05-22,WV,1616,83213,84829,71
2020-05-23,WV,1717,82027,83744,72
2020-05-24,WV,1759,83935,85694,72
2020-05-25,WV,1774,84551,86325,72
2020-05-26,WV,1854,85957,87811,74
2020-05-27,WV,1867,86594,88461,74
2020-05-28,WV,1906,88409,90315,74
2020-05-29,WV,1951,91426,93377,74
2020-05-30,WV,1974,93916,95890,75
2020-05-31,WV,2010,95612,97622,75
2020-06-01,WV,2017,96078,98095,75
2020-06-02,WV,2041,98502,100543,77
2020-06-03,WV,2071,101697,103768,78
2020-06-04,WV,2092,103957,106049,78
2020-06-05,WV,2119,106399,108518,84
2020-06-06,WV,2131,107592,109723,84
2020-06-07,WV,2144,109663,111807,84
2020-06-08,WV,2153,111452,113605,84
2020-06-09,WV,2169,112169,114338,84
2020-06-10,WV,2188,115802,117990,85
2020-06-11,WV,2212,118908,121120,85
2020-06-12,WV,2233,121806,124039,86
2020-06-13,WV,2259,125258,127517,88
2020-06-14,WV,2289,128910,131199,88
2020-06-15,WV,2298,129655,131953,88
2020-06-16,WV,2341,134730,137071,88
2020-06-17,WV,2376,138994,141370,88
2020-06-18,WV,2418,142011,144429,88
2020-06-19,WV,2435,143579,146014,88
2020-06-20,WV,2486,145910,148396,88
2020-06-21,WV,2543,148046,150589,89
2020-06-22,WV,2552,148652,151204,89
2020-06-23,WV,2582,151746,154328,92
2020-06-24,WV,2629,154419,157048,92
2020-06-25,WV,2661,156043,158704,92
2020-06-26,WV,2712,159245,161957,92
2020-06-27,WV,2761,161894,164655,93
2020-06-28,WV,2817,163691,166508,93
2020-06-29,WV,2870,166785,169655,93
2020-06-30,WV,2905,168859,171764,93
2020-07-01,WV,2932,170420,173352,93
2020-07-02,WV,3053,175288,178341,93
2020-07-03,WV,3126,177576,180702,93
2020-07-04,WV,3141,178288,181429,94
2020-07-05,WV,3262,181559,184821,94
2020-07-06,WV,3442,185539,188981,95
2020-07-07,WV,3461,186386,189847,95
2020-07-08,WV,3707,190208,193915,95
2020-07-09,WV,3826,193363,197189,95
2020-07-10,WV,3983,197220,201203,95
2020-07-11,WV,4074,199749,203823,95
2020-07-12,WV,4207,202829,207036,96
2020-07-13,WV,4259,203966,208225,96
2020-07-14,WV,4407,209605,214012,97
2020-07-15,WV,4557,213347,217904,97
2020-07-16,WV,4657,214517,219174,99
2020-07-17,WV,4783,217769,222552,100
2020-07-18,WV,4894,220617,225511,100
2020-07-19,WV,5042,225946,230988,100
2020-07-20,WV,5142,229838,234980,100
2020-07-21,WV,5199,235127,240326,101
2020-07-22,WV,5206,237181,242387,101
2020-07-23,WV,5550,245522,251072,103
2020-07-24,WV,5695,247478,253173,103
2020-07-25,WV,5821,251093,256914,103
2020-03-07,WY,0,0,0,0
2020-03-08,WY,0,0,0,0
2020-03-09,WY,0,0,0,0
2020-03-10,WY,0,0,0,0
2020-03-11,WY,0,0,0,0
2020-03-12,WY,1,0,1,0
2020-03-13,WY,1,0,1,0
2020-03-14,WY,2,0,2,0
2020-03-15,WY,3,0,3,0
2020-03-16,WY,3,0,3,0
2020-03-17,WY,10,95,105,0
2020-03-18,WY,15,178,193,0
2020-03-19,WY,18,271,289,0
2020-03-20,WY,19,331,350,0
2020-03-21,WY,23,438,461,0
2020-03-22,WY,24,438,462,0
2020-03-23,WY,26,592,618,0
2020-03-24,WY,29,710,739,0
2020-03-25,WY,44,954,998,0
2020-03-26,WY,53,1052,1105,0
2020-03-27,WY,70,1211,1281,0
2020-03-28,WY,82,1475,1557,0
2020-03-29,WY,86,1554,1640,0
2020-03-30,WY,94,1840,1934,0
2020-03-31,WY,109,1999,2108,0
2020-04-01,WY,130,2218,2348,0
2020-04-02,WY,150,2439,2589,0
2020-04-03,WY,162,2704,2866,0
2020-04-04,WY,187,2945,3132,0
2020-04-05,WY,197,3040,3237,0
2020-04-06,WY,210,3719,3929,0
2020-04-07,WY,216,3789,4005,0
2020-04-08,WY,221,3843,4064,0
2020-04-09,WY,230,3920,4150,0
2020-04-10,WY,253,4736,4989,0
2020-04-11,WY,261,5198,5459,0
2020-04-12,WY,261,5198,5459,0
2020-04-13,WY,275,5689,5964,1
2020-04-14,WY,275,5689,5964,1
2020-04-15,WY,287,6042,6329,2
2020-04-16,WY,296,6131,6427,2
2020-04-17,WY,296,6131,6427,2
2020-04-18,WY,305,6217,6522,2
2020-04-19,WY,309,6972,7281,2
2020-04-20,WY,313,7073,7386,2
2020-04-21,WY,320,7301,7621,6
2020-04-22,WY,322,7301,7623,6
2020-04-23,WY,326,7241,7567,7
2020-04-24,WY,349,7696,8045,7
2020-04-25,WY,349,7797,8146,7
2020-04-26,WY,362,7797,8159,7
2020-04-27,WY,370,7797,8167,7
2020-04-28,WY,389,8226,8615,7
2020-04-29,WY,536,8681,9217,7
2020-04-30,WY,544,8902,9446,7
2020-05-01,WY,559,9136,9695,7
2020-05-02,WY,566,9463,10029,7
2020-05-03,WY,579,9640,10219,7
2020-05-04,WY,586,9868,10454,7
2020-05-05,WY,596,10319,10915,7
2020-05-06,WY,604,11403,12007,7
2020-05-07,WY,631,11403,12034,7
2020-05-08,WY,635,11403,12038,7
2020-05-09,WY,644,11403,12047,7
2020-05-10,WY,661,11403,12064,7
2020-05-11,WY,662,11403,12065,7
2020-05-12,WY,675,14384,15059,7
2020-05-13,WY,675,14384,15059,7
2020-05-14,WY,701,14729,15430,7
2020-05-15,WY,715,15307,16022,7
2020-05-16,WY,716,15678,16394,7
2020-05-17,WY,754,16331,17085,8
2020-05-18,WY,754,16331,17085,8
2020-05-19,WY,766,17084,17850,10
2020-05-20,WY,787,18053,18840,11
2020-05-21,WY,787,18053,18840,11
2020-05-22,WY,803,18621,19424,12
2020-05-23,WY,813,19221,20034,12
2020-05-24,WY,813,19221,20034,12
2020-05-25,WY,838,19551,20389,12
2020-05-26,WY,850,20652,21502,13
2020-05-27,WY,850,20652,21502,13
2020-05-28,WY,874,22286,23160,15
2020-05-29,WY,891,22378,23269,15
2020-05-30,WY,898,23185,24083,16
2020-05-31,WY,903,23490,24393,16
2020-06-01,WY,910,24237,25147,17
2020-06-02,WY,910,24832,25742,17
2020-06-03,WY,915,25713,26628,17
2020-06-04,WY,915,26074,26989,17
2020-06-05,WY,933,26679,27612,17
2020-06-06,WY,939,27569,28508,17
2020-06-07,WY,947,27804,28751,17
2020-06-08,WY,960,29014,29974,17
2020-06-09,WY,970,29366,30336,17
2020-06-10,WY,980,29872,30852,18
2020-06-11,WY,1009,30609,31618,18
2020-06-12,WY,1027,30873,31900,18
2020-06-13,WY,1050,32005,33055,18
2020-06-14,WY,1060,32005,33065,18
2020-06-15,WY,1060,31546,32606,18
2020-06-16,WY,1089,33324,34413,18
2020-06-17,WY,1114,33955,35069,18
2020-06-18,WY,1144,35010,36154,18
2020-06-19,WY,1173,35301,36474,20
2020-06-20,WY,1179,26162,27341,20
2020-06-21,WY,1197,26162,27359,20
2020-06-22,WY,1230,26162,27392,20
2020-06-23,WY,1254,27485,28739,20
2020-06-24,WY,1279,28869,30148,20
2020-06-25,WY,1326,28869,30195,20
2020-06-26,WY,1368,30406,31774,20
2020-06-27,WY,1392,30406,31798,20
2020-06-28,WY,1417,30406,31823,20
2020-06-29,WY,1450,30406,31856,20
2020-06-30,WY,1487,32185,33672,20
2020-07-01,WY,1514,32185,33699,20
2020-07-02,WY,1550,33693,35243,20
2020-07-03,WY,1582,33693,35275,20
2020-07-04,WY,1606,33693,35299,20
2020-07-05,WY,1634,33693,35327,20
2020-07-06,WY,1634,33693,35327,20
2020-07-07,WY,1711,36078,37789,20
2020-07-08,WY,1740,36078,37818,21
2020-07-09,WY,1774,37271,39045,21
2020-07-10,WY,1790,38077,39867,21
2020-07-11,WY,1839,38077,39916,21
2020-07-12,WY,1862,38077,39939,21
2020-07-13,WY,1862,38077,39939,21
2020-07-14,WY,1951,38077,40028,22
2020-07-15,WY,1985,40929,42914,22
2020-07-16,WY,2026,41426,43452,24
2020-07-17,WY,2069,41927,43996,24
2020-07-18,WY,2108,41927,44035,24
2020-07-19,WY,2126,41927,44053,24
2020-07-20,WY,2187,41927,44114,24
2020-07-21,WY,2238,41927,44165,25
2020-07-22,WY,2288,41927,44215,25
2020-07-23,WY,2346,45823,48169,25
2020-07-24,WY,2405,45823,48228,25
2020-07-25,WY,2446,45823,48269,25
